번쨰 기사입니다	neutral
이후 약세로 역부족지난해 돼지 값이 전년 대비 오르면서 4년 연속 4천500원	negative
가량 올랐다	neutral
이상을 기록하며 호황을 이어갔다	positive
돈가 강세를 뒷받침한 결과다	positive
문턱은 넘지 못했다	neutral
이후 물량 증가로 강세를 이어	positive
돈 하락 시 경영 악화 우려이유 후 육성에 관심 집중을양돈농가 중 절반이 넘는 농가가 MSY 18두 미만을 기록하고 	negative
농가의 생산 성적을 최종 취합한 결과	neutral
가격 하락시 이들 농가들의 경영악화가 우려되고 	negative
농가수 비율 분석 자료에 따르면 3천320농가 중 	neutral
비교해 봤을 때 MSY 18두 미만 비율은 56.5	neutral
소폭 늘어났다	neutral
이유 후 육성률이 낮아진 영향으로 풀이되고 	negative
돈 호조로 입식 는 영향새해 역시 증가세 이어	positive
연간 출하물량인 1천654만마리를 넘어섰다	neutral
연말까지 1천670만두에 이를 것으로 예상된다	neutral
연속 사상최고의 출하두수 기록을 세우게 됐다	positive
결과로 새해도 출하 증가세가 이어질 전망이다	positive
해로 만들겠다고 	positive
이중 축산 사육 환경도 근본적으로 개선할 것이라고 강조했다	neutral
산란계 신규농장에게는 보다 넓어진 사육밀도 기준을 적용할 것이라고 강조했다	neutral
시설 개선 자금을 지원하고	positive
선택할 수 있도록 사육환경 표시 제도를 도입하겠다고 	neutral
관계부처와 협의를 거쳐 구제방안을 마련하겠다고 	neutral
값 하락세가 올해도 이어질 전망이다	negative
지난해 1월(4천582원)에는 미치지 못할 것으로 내다봤다	negative
전 수준을 밑돌 것으로 예상했다	negative
전년 대비 상승세를 기록했으나 10월부터 하락세로 전환됐으며 농경연 전망에 따르면 적어도 내년 상반기까지는 이 같은 흐름이 내내 지속된다는 것이다	negative
늘고 3월과 6월을 제외하고	neutral
상반기 돼지 출하물량은 17년에 비해 1.2	neutral
한돈 생산이 늘면서 수입량은 감소	neutral
또 이 기간 돼지 사육두수는 전년 대비 1.6	neutral
최고종개협  신규 종돈장 입식에다 일반농장 직수입 여파작년 종돈 수입 물량이 크게 증가하며 5년 만에 4천두를 넘어섰다	neutral
지난해 종돈수입두수는 통관 기준 4천409두로 전년 3천76두에 비해 43.3	neutral
두에 이어 사상 3번째 많은 물량이다	neutral
두로 가장 많았으며 그 다음이 프랑스 1천258두	neutral
수 36두) 순으로 들어왔다	neutral
업체 10곳에서 165두를 수입했다	neutral
특히 일반 농장에서 수입 물량이 전년	positive
수입한 물량도 한 몫 했다	neutral
1번쨰 기사입니다	neutral
만두 넘었다종개협 작년 22만두 전년보다 10.8% 증가최근 3년 연속 후보돈	positive
실적을 분석한 결과 F1 후보돈	neutral
매두수는 16만5천817두로 전년	neutral
증가했다	positive
늘었다	positive
모돈에 대한 투자를 활발히 진행한 영향으로 풀이된다	neutral
특히 합성돈 판매량도 꾸준히 늘어나고 	positive
연속 거래량 제로를 기록한 것으로 나타났다	neutral
돈육 선물거래도 이뤄지지 않았다	negative
연속 거래가 없었다	neutral
효과가 없었던 셈이다	negative
모르는 게 거래 부진의 가장 큰 이유로 지목된다고 	negative
소폭 줄었다	neutral
생산성은 신통치 못했다	negative
최근 양돈타임스가 17년도 돼지 도축두수와 전년도 12월 모돈 두수를 이용해 구해본 17년도 MSY	neutral
두에 비해 낮았다	neutral
돼지 도축두수는 1.1	neutral
생산성은 뒷걸음질 친 것이다	negative
증가하고 있는 가운데 자돈 질병 피해가 여전히 큰 때문으로 풀이되고 	negative
제주 제외한 탕박으로농가 체감 가격 낮게 보여최근 한돈 가격 정산 방법 변화에 따라 전국 한돈 가격 기준도 	neutral
탕박 가격이 전국 돼지가격의 기준점이 되고 	neutral
전국 평균 탕박 가격은 제주 지역을 포함한 가격과 포함하지 않은 가격만이 고시	neutral
정산기준을 탕박으로 변경 시 제주를 제외한 전국 탕박 평균가격으로 정산한다’라는 협약내용에 따른 것이다	neutral
돼지 값은 예년보다 낮아 보이는 착시 현상을 겪을 수도 있을 것으로 예측된다	negative
작년 제주를 제외한 연평균 돼지 값은 4천640원을 형성한 것으로 나타났다	neutral
돈육 수입 6년만에 최고	positive
자급률 하락17년 37만톤 전년비 16	negative
↓지난해 돼지고기 수입량이 크게 늘면서 	positive
구제역 직후인 11년(37만1천톤)을 제외하고 	neutral
감소했다	negative
이로써 지난해 돼지고기 수입량은 36만9천톤으로 16년 31만8천톤보다 15.9	neutral
늘었다	neutral
점을 감안하면 사실상 지난해 수입량이 사상 최고치인 셈이다	positive
가격이 강세를 기록한 영향이 크다	positive
한돈을 대체할 가공용 부위 수입이 증가한 것이다	neutral
자급률은 하락했다	negative
한돈 생산량은 약 90만톤을 기록했다	neutral
낮아	neutral
부위별로는 삼겹살이 17만2천톤으로 일년전 15만톤 대비 15.7	neutral
늘었다	neutral
가량 적은 3만6천톤이 들어왔다	neutral
저무는	neutral
돼지 값은 약세가 불가피할 것으로 전망됐다	negative
돼지 값 하락을 점쳤다	negative
자연히 출하물량 역시 1천700만마리는 무난히 넘길 것이란 전망이다	neutral
연속 돼지 출하 최고치 기록을 갈아 치우게 되는 셈이다	neutral
이처럼 출하가 증가하는 가운데 소비 측면에서는 특별한 호재가 보이지 않는다	negative
대체 수요 요인이 빠져나가는 시장 상황을 돼지 값 하락의 한 축으로 지적했다	negative
특히 박피가 중단되고 탕박으로의 전환은 돼지 값 부담 요인으로 지목되기도 했다	negative
소비 시장의 한 변화로 내다봤다	neutral
육박했던 지난해와 견줘 약세를 형성할 것이란 데 이견이 없었다	negative
더욱이 이들은 수입육의 공세도 주목했다	neutral
특히 지금까지는 저렴한 가격이 주요 경쟁력이었다면 최	positive
돼지고기 등 수입육이 고급화하고 있는 점을 위협 요소로 꼽았다	negative
소비자들의 인식이 변화하고 있다는 점도 우려하며 한돈의 차별화를 시급한 과제로 지목했다	negative
목소리로 걱정했다	negative
농가들의 노력을 주문했다	negative
ASF 발병 시 돼지 일시 이동중지농축산부 방역 강화 위해일시 이동중지 명령 대상 전염병에 아프리카돼지열병	negative
시행 규칙 일부 개정안을 마련해 관련업계 의견조회에 들어갔다	neutral
치사율이 높은 아프리카돼지열병도 일시 이동중지 명령 대상 전염병으로 추가했다	negative
몽골에 인접한 러시아에 발생하는 등 국내 유입 위험성도 높아지고 	negative
제주도에 타 지방 돼지고기의 반입이 허용되면서 제주도 양돈농가 채산성이 악화될 수 있다는 보고서가 나왔다	negative
제주도 양돈산업이 침체될 수 있다고 	negative
지난 16년 기준 도내 양돈산업의 총 매출액은 4천71억원으로 05년	neutral
증가했다	positive
상대적으로 저렴한 타 지역 돼지고기가 유입되면서 도내 가격과 전국 가격 간 격차가 줄어들 것이란 전망이다	positive
원서 335원으로 줄었다고 지적했다	negative
향후 반입 물량이 확대될 경우 지역 양돈농가 채산성 악화 가능성이 있다고 	negative
타 지역 한돈을 제주산으로 속여 판매함으로써 제주 돼지고기 브랜드 가치를 저하시키거나 전염병이 유입될 우려도 있다고 	negative
2번쨰 기사입니다	neutral
연중 생산성 11월이 가장 좋다	positive
평균보다 높아폭염 후유증 벗어나 	positive
연중 가장 높은 생산성을 기록한 것으로 나타났다	positive
경우 두당 섭취량 증가와 출하일령 감소로 19.1두를 기록	neutral
일로 가장 빨랐다	neutral
일교차도 줄어 	positive
이 같은 성적	neutral
