0번쨰 기사입니다	neutral
돈 호조로 입식 는 영향새해 역시 증가세 이어	positive
연간 출하물량인 1천654만마리를 넘어섰다	neutral
연말까지 1천670만두에 이를 것으로 예상된다	neutral
연속 사상최고의 출하두수 기록을 세우게 됐다	positive
결과로 새해도 출하 증가세가 이어질 전망이다	positive
돈 하락 시 경영 악화 우려이유 후 육성에 관심 집중을양돈농가 중 절반이 넘는 농가가 MSY 18두 미만을 기록하고 	negative
농가의 생산 성적을 최종 취합한 결과	neutral
가격 하락시 이들 농가들의 경영악화가 우려되고 	negative
농가수 비율 분석 자료에 따르면 3천320농가 중 	neutral
비교해 봤을 때 MSY 18두 미만 비율은 56.5	neutral
소폭 늘어났다	neutral
이유 후 육성률이 낮아진 영향으로 풀이되고 	negative
이후 약세로 역부족지난해 돼지 값이 전년 대비 오르면서 4년 연속 4천500원	negative
가량 올랐다	neutral
이상을 기록하며 호황을 이어갔다	positive
돈가 강세를 뒷받침한 결과다	positive
문턱은 넘지 못했다	neutral
이후 물량 증가로 강세를 이어	positive
최고종개협  신규 종돈장 입식에다 일반농장 직수입 여파작년 종돈 수입 물량이 크게 증가하며 5년 만에 4천두를 넘어섰다	neutral
지난해 종돈수입두수는 통관 기준 4천409두로 전년 3천76두에 비해 43.3	neutral
두에 이어 사상 3번째 많은 물량이다	neutral
두로 가장 많았으며 그 다음이 프랑스 1천258두	neutral
품종별로 보면 	neutral
수 126두) △버크셔	neutral
업체 10곳에서 165두를 수입했다	neutral
특히 일반 농장에서 수입 물량이 전년	positive
수입한 물량도 한 몫 했다	neutral
값 하락세가 올해도 이어질 전망이다	negative
지난해 1월(4천582원)에는 미치지 못할 것으로 내다봤다	negative
전 수준을 밑돌 것으로 예상했다	negative
전년 대비 상승세를 기록했으나 10월부터 하락세로 전환됐으며 농경연 전망에 따르면 적어도 내년 상반기까지는 이 같은 흐름이 내내 지속된다는 것이다	negative
늘고 3월과 6월을 제외하고	neutral
이에 따라 상반기 돼지 출하물량은 1	neutral
많을 것으로 추산됐다	neutral
한돈 생산이 늘면서 수입량은 감소	neutral
또 이 기간 돼지 사육두수는 전년 대비 1.6	neutral
해로 만들겠다고 	positive
이중 축산 사육 환경도 근본적으로 개선할 것이라고 강조했다	neutral
산란계 신규농장에게는 보다 넓어진 사육밀도 기준을 적용할 것이라고 강조했다	neutral
사육환경 표시 제도를 도입하겠다고 	positive
관계부처와 협의를 거쳐 구제방안을 마련하겠다고 	neutral
1번쨰 기사입니다	neutral
만두 넘었다종개협 작년 22만두 전년보다 10.8% 증가최근 3년 연속 후보돈	positive
실적을 분석한 결과 F1 후보돈	neutral
매두수는 16만5천817두로 전년	neutral
증가했다	positive
늘었다	positive
모돈에 대한 투자를 활발히 진행한 영향으로 풀이된다	neutral
특히 합성돈 판매량도 꾸준히 늘어나고 	positive
돈육 수입 6년만에 최고	positive
P ↓	negative
지난해 돼지고기 수입량이 크게 늘면서 	positive
구제역 직후인 11년(37만1천톤)을 제외하고 	neutral
감소했다	negative
이로써 지난해 돼지고기 수입량은 36만9천톤으로 16년 31만8천톤보다 15.9	neutral
늘었다	neutral
많은 양으로 11년도가 구제역	neutral
점을 감안하면 사실상 지난해 수입량이 사상 최고치인 셈이다	positive
가격이 강세를 기록한 영향이 크다	positive
한돈을 대체할 가공용 부위 수입이 증가한 것이다	neutral
자급률은 하락했다	negative
한돈 생산량은 약 90만톤을 기록했다	neutral
낮아	neutral
부위별로는 삼겹살이 17만2천톤으로 일년전 15만톤 대비 15.7	neutral
늘었다	neutral
가량 적은 3만6천톤이 들어왔다	neutral
연속 거래량 제로를 기록한 것으로 나타났다	neutral
돈육 선물거래도 이뤄지지 않았다	negative
연속 거래가 없었다	neutral
효과가 없었던 셈이다	negative
모르는 게 거래 부진의 가장 큰 이유로 지목된다고 	negative
소폭 줄었다	neutral
탓 분석지난해 돼지 값이 호조를 보였지만 	negative
다	neutral
두에 비해 낮았다	neutral
돼지 도축두수는 1.1	neutral
생산성은 뒷걸음질 친 것이다	negative
증가하고 있는 가운데 자돈 질병 피해가 여전히 큰 때문으로 풀이되고 	negative
제주 제외한 탕박으로농가 체감 가격 낮게 보여최근 한돈 가격 정산 방법 변화에 따라 전국 한돈 가격 기준도 	neutral
탕박 가격이 전국 돼지가격의 기준점이 되고 	neutral
전국 평균 탕박 가격은 제주 지역을 포함한 가격과 포함하지 않은 가격만이 고시	neutral
정산기준을 탕박으로 변경 시 제주를 제외한 전국 탕박 평균가격으로 정산한다’라는 협약내용에 따른 것이다	neutral
돼지 값은 예년보다 낮아 보이는 착시 현상을 겪을 수도 있을 것으로 예측된다	negative
작년 제주를 제외한 연평균 돼지 값은 4천640원을 형성한 것으로 나타났다	neutral
저무는	neutral
돼지 값은 약세가 불가피할 것으로 전망됐다	negative
돼지 값 하락을 점쳤다	negative
자연히 출하물량 역시 1천700만마리는 무난히 넘길 것이란 전망이다	neutral
연속 돼지 출하 최고치 기록을 갈아 치우게 되는 셈이다	neutral
이처럼 출하가 증가하는 가운데 소비 측면에서는 특별한 호재가 보이지 않는다	negative
대체 수요 요인이 빠져나가는 시장 상황을 돼지 값 하락의 한 축으로 지적했다	negative
특히 박피가 중단되고 탕박으로의 전환은 돼지 값 부담 요인으로 지목되기도 했다	negative
소비 시장의 한 변화로 내다봤다	neutral
육박했던 지난해와 견줘 약세를 형성할 것이란 데 이견이 없었다	negative
더욱이 이들은 수입육의 공세도 주목했다	neutral
특히 지금까지는 저렴한 가격이 주요 경쟁력이었다면 최	positive
돼지고기 등 수입육이 고급화하고 있는 점을 위협 요소로 꼽았다	negative
소비자들의 인식이 변화하고 있다는 점도 우려하며 한돈의 차별화를 시급한 과제로 지목했다	negative
목소리로 걱정했다	negative
농가들의 노력을 주문했다	negative
제주도에 타 지방 돼지고기의 반입이 허용되면서 제주도 양돈농가 채산성이 악화될 수 있다는 보고서가 나왔다	negative
제주도 양돈산업이 침체될 수 있다고 	negative
증가했다	positive
상대적으로 저렴한 타 지역 돼지고기가 유입되면서 도내 가격과 전국 가격 간 격차가 줄어들 것이란 전망이다	positive
원서 335원으로 줄었다고 지적했다	negative
한국은행은 현재까지 제주로 반입된 다른 지역 한돈물량이 도내 도축물량의 1	neutral
향후 반입 물량이 확대될 경우 지역 양돈농가 채산성 악화 가능성이 있다고 	negative
타 지역 한돈을 제주산으로 속여 판매함으로써 제주 돼지고기 브랜드 가치를 저하시키거나 전염병이 유입될 우려도 있다고 	negative
ASF 발병 시 돼지 일시 이동중지농축산부 방역 강화 위해일시 이동중지 명령 대상 전염병에 아프리카돼지열병	negative
시행 규칙 일부 개정안을 마련해 관련업계 의견조회에 들어갔다	neutral
치사율이 높은 아프리카돼지열병도 일시 이동중지 명령 대상 전염병으로 추가했다	negative
몽골에 인접한 러시아에 발생하는 등 국내 유입 위험성도 높아지고 	negative
2번쨰 기사입니다	neutral
연속 줄었다	positive
) 줄여 책정했다	neutral
최근 사료가격이 안정세를 보이면서 	neutral
법인은 신청 가능하며 기존에 사료구매 정책자금 대출자도 추가로 지원이 가능하다	positive
발생 농가는 사업 대상에서 제외된다	neutral
국제 곡물시장 안정세 위협	negative
유지하던 안정세를 위협받고 	negative
국내 양돈농가 경영도 어려워질 수 있어 	negative
가능성이 높게 점쳐지고 	neutral
달한다고 	neutral
실제 라니냐의 징후들이 나타나고 	neutral
이상 한파가 바로 그것이다	negative
아르헨티나 등 주요 곡물 생산지대에 가뭄이 올 수 있다는 점이다	negative
콩 등 곡물 가격 상승이 불가피해진다	negative
폭등할 수 있다고 	negative
향상되지 않고 	negative
가량 감소한 가운데 1등급 이상이 64.4	negative
기록했다	neutral
P 상승한 수치다	neutral
1등급 이상 출현율이 63.8	neutral
P 올랐다	neutral
수준에도 못 미친 것이다	negative
개선이 이뤄지지 않은 상황으로 풀이되고 	negative
노력을 기울여야 한다고 	negative
연중 생산성 11월이 가장 좋다	positive
평균보다 높아폭염 후유증 벗어나 	positive
연중 가장 높은 생산성을 기록한 것으로 나타났다	positive
경우 두당 섭취량 증가와 출하일령 감소로 19.1두를 기록	neutral
일로 가장 빨랐다	neutral
이는 모돈이 하절기 폭염 후유증에서 벗	positive
일교차도 줄어 	neutral
만두로 사상최고를 기록하기도 했다	positive
새해 들어 미국산 냉장 돼지고기 등 수입 돈육 관세가 추가로 하향 조정된다	neutral
자리수로 떨어졌다	neutral
떨어지게 된다	neutral
낮아진다	neutral
냉장 삼겹살은 멕시코 다음으로 캐나다산 비중이 크다	neutral
관세가 올해 없어진다	neutral
조정된다	neutral
증가로새해 돼지 값이 약세서 	negative
각각 하락했다	neutral
떨어졌다	neutral
전체 출하물량이 많은 것이 한 원인이	negative
이 기간 일평균 돼지 출하물량은 7만7천여마리로 일년전 6만7천두에 비해 14	neutral
경매두수가 크게 늘어 돼지 값 하락을 부추긴 것으로 파악된다	negative
돼지 값 약세의 한 원인이 되고 	negative
소비 늘었다	positive
수입 증가에도 재고는 줄어	neutral
지난해 돼지고기 수입량은 늘었지만 	negative
감소했다	negative
11월 돼지고기 수입량이 10월 대비 50	neutral
가량 줄었다	neutral
지난해 돼지고기 수입량이 전년 대비 증가하면서 재고도 전년비 높은 수준을 유지해오다 5개월만에 감소세로 돌아선 것이다	negative
돈육 수입량을 보면 34만여톤으로 일년전보다 20	neutral
수입 돈육의 소비가 많았다는 얘기가 된다	neutral
적고 	neutral
무한리필 삼겹살점들이 인기를 끌었던 16년에 비해서는 수요처가 많이 줄었던 영향이 크다	neutral
각	neutral
감소했다	neutral
가격이 오르면서 	neutral
평창 동계 올림픽 수요로 안정을 찾을 것으로 예측됐다	positive
동향분석회의를 개최했다	neutral
급식 물량도 부진하는 등 수요 호재가 없어 돼지 값이 낮게 형성되고 	negative
가격은 다시 오를 것으로 전망	neutral
가격도 급등락 없이 안정적으로 유지되고 있다고 만족해했다	positive
3번쨰 기사입니다	neutral
올해 한돈 자조금 사업 예산이 343억4천만원으로 확정됐다	neutral
이 같이 사업 예산을 승인했다	neutral
조성 금액은 △농가거출금=177억6천만원 △정부지원금=54억3천만원 △이익 잉여금	neutral
이에 따	neutral
)=8억5천만원 △수급안정	neutral
돼지 이상육 발생을 증가시키는 법안을 고시하는 등 엇박자 행보를 보이고 	negative
안전한 한돈 생산을 요구받고 	negative
박피 도축 과정에서의 안전성 문제를 제기했다	negative
산업에도 치명타가 될 수 있다는 것	negative
이에 업계는 박피 도축 전면 중단에 합의하며 불행의 싹을 미리 자르는 결단을 보였다	negative
있는 등 나날이 안전한 한돈 생산을 위한 경각심이 높아지고 	positive
그러나 최근 정부는 자돈 구제역 2회 접종을 골자로 한 구제역 예방접종	neutral
접종으로 변경된다	neutral
문제는 2회 접종 의무화시 이상육 발생도 크게 증가	negative
른 뇌관이 될 수 있다	neutral
크게 반발했다	negative
이상육 절감 대책이 마련된 이후에야 조정돼야 한다고 	neutral
운영이 필요하다고 	neutral
오는 법안을 개정하고 있어 농가들의 불만의 목소리가 점점 높아지고 	negative
앞으로 돼지 증가할 일만 남았다	negative
전년 동기와의 차이는 더 벌렸다	neutral
감소했다	neutral
반면 전년동기 1천37만마리에 견줘서는 1.4	neutral
그 차이가 더 커진 셈이다	neutral
전 97만4천마리에 비해 2.6	neutral
더 큰 폭의 증가세를 보였다	neutral
향후 돼지 사육두수가 더 증가할 여지가 충분한 상황	neutral
증가해 향후 출하물량 증가도 예상되고 	neutral
감소했으며 1천	negative
반면 5천두 이상 농가 사육두수는 426만마리로 전년 대비 5.5	neutral
이상은 늘었다	neutral
이로써 양돈농가당 돼지 사육두수는 2천386마리로 전년비 5.3	neutral
예상돼올해 한돈 생산량만 100만톤을 돌파할 것으로 보인다	neutral
축산물품질평가원에 따르면 지난해 한돈 생산량은 99만8천톤으로 전년	positive
전망돼 한돈공급량은 102만톤으로 추산되고 	neutral
이로써 한돈공급량 100만톤 시대가 예상되고 	neutral
사상 최고의 공급량을 기록한 것으로 분석됐다	positive
↓	neutral
양돈사료량이 사상 최고치를 기록했다	positive
최근 농림축산식품	neutral
가량 늘었다	neutral
전 구간이 많았던 것이다	neutral
많았다	neutral
연속 연간 양돈사료량 사상 최고치를 경신하게 됐다	positive
지난해 돼지 사육두수와 출하물량이 사상 최고치를 기록했던 만큼 양돈사료량에도 양돈산업의 양적 성장이 반영된 결과다	positive
가량 감소한 325만여톤을 기록했다	negative
가장 두드러진 증가세를 보인 것은 번식돈용 사료였다	neutral
전에 견줘 6	neutral
퇴행적 현상 용납 못해	negative
탕박 지급률제로 돼지 정산을 하는 것으로 나타났다	negative
협회는 최근 전국 육가공업체를 대상으로 돼지 정산 방법에 대한 조사를 실시했다	neutral
(16개소)에 불과한 것으로 나타났으며	neutral
이에 협회는 지난 17일 6번째 성명서를 발표하고	neutral
불과한 상황에서 농가가 도축시 내는 등급판정수수료가 무슨 의미가 있는지 되묻고 	negative
촉구했다	negative
4번쨰 기사입니다	neutral
[양돈전망	neutral
한돈 올해 내년 하락하다	negative
20년부터 올라농경연 2018 양돈전망	neutral
올해와 내년까지 돼지고기 공급량 증가로 돼지 값 하락이 점쳐지고 	negative
수입량 역시 크게 줄지 않을 것이란 분석이다	neutral
올해를 비롯해 중장기 양돈수급 전망을 발표했다	neutral
이 내용을 정리	neutral
19년 4천281원까지 떨어져	neutral
질병 준 영향	neutral
각각 늘어	negative
돼지고기 가격이 높게 형성되면서 지속 증가해 지난해 9월 1천79만 마리로 역대 최대 사육두수를 갱신했다	positive
이에 따라 지난해 돼지 도축두수는 16년보다 1.1	neutral
증가했다	positive
이처럼 한돈 생산량 증가에도 불구하고 수요 증가와 관세 인하로 지난해 돼지고기 수입량은 16년 31만9천톤보다 16	neutral
늘었다	neutral
양돈 선진국에 비해 상당히 낮은 수준이다	negative
또한 이유 후 육성률도 양돈 선진국의 경우 90	neutral
사양관리 기술이 부족하기 때문이다	negative
이유 후 폐사가 많고 	negative
다행히 국내 양돈 생산성은 향상되고 	positive
MSY는 13.5마리에서 16.9마리로 증가했다	neutral
향상된 것으로 판단된다	positive
이상 감소하는 등 질병 발생이 과거보다 줄었기 때문이다	negative
사료 요구율이 향상된 것으로 나타났다	positive
■ 소비	neutral
가장 높았다	neutral
조사되었다	neutral
선호하는 부위는 삼겹살이었으며 다음으로 목살	neutral
순으로 나타났다	neutral
올해 한돈 소비를 늘리겠다는 응답이 줄이겠다는 응답보다 높게 조사되었고 수입 돼지고기는 소비를 줄이겠다는 응답 비중이 더 높았다	neutral
돼지 도매가격 상승은 공급보다 수요 증가 측면이 견인한 것으로 분석되고 	neutral
국내 생산량과 수입량이 증가해 가격 하락 요인으로 작용했으나 수요가 10	neutral
대비 7.5% 올랐다	neutral
↑ 으로 모두 올랐다	neutral
↑) 모두 상승했다	neutral
전망되어 국내 도매원가도 19년까지 하락할 것으로 전망된다	negative
EU산 돼지고기는 관세가 점진적	neutral
이후 상승세를 유지할 것으로 전망된다	neutral
아시아 지역으로 대신 수출하려 할 수 있어 	neutral
전망되어 수입량 감소가 예상되나 주요 수입국의 상황과 국내 돼지가격이 평년 수준 유지한다는 점을 가정하면 수입량이 크게 감소하지는 않을 것으로 전망된다	neutral
장기 수급 전망돼지 가격이 상승하면서 양돈 농가의 모돈 사육 의향이 상승	neutral
전망된다	neutral
모돈수 증가로 올해 전체 사육 두수는 1천70∼1천90만 마리로 전망된다	neutral
돼지고기 생산량은 93만톤으로 전망된다	neutral
가격 하락으로 지난해보다 감소한 34만3천 톤으로 전망된다	negative
전년 동월보다 낮을 것으로 전망된다	neutral
2월보다 상승한 4천400	neutral
4월보다 상승한 평균 5천	neutral
이상에서 형성될 것으로 전망된다	neutral
18년 연평균 돼지 도매가격은 4천481원	neutral
가격 하락으로 21년까지 감소할 것으로 예상된다	neutral
22년부터 다시 증가세로 전환돼 27년 연평균 사육 마릿수는 1천150만 마리 내외가 될 것으로 보인다	neutral
생산성이 향상되어 모돈수는 점차 감소할 것으로 전망된다	negative
증가 후 2020∼21년까지 감소할 것으로 전망된다	negative
이후 돼지고기 생산량은 증가세로 전환되어 	neutral
표 참조>수입량은 FTA 타결에 따른 관세 인하 및 철폐와 육류 소비 증가 등으로 지속적으로 증가해 27년 37만9천 톤 내외가 될 것으로 전망된다	neutral
돼지고기 생산량이 증가하면서 내년 돼지 도매가격은 4천281원까지 하락할 것으로 전망된다	negative
도축 마릿수 감소로 지육가격이 상승세로 전환되고 	neutral
고돈가가 지속되면서 국내 돼지 사육두수가 크게 증가한 가운데 지역별로는 충남과 전남이 가장 많이 늘었다	neutral
늘었다	neutral
마리서 지난해까지 4년 연속 증가했다	neutral
이는 무엇보다	neutral
이 기간 지속돼온 고돈가의 영향이다	neutral
가량 증가한 셈이다	neutral
지역별로 보면 차이가 크게 나타나고 	neutral
그쳤다	neutral
늘었다	neutral
늘었다	neutral
전년비 2.3	neutral
두수가 증가했으나 지역별로 차이는 컸다	neutral
17년 1인당 돈육 소비 24.5kg전년보다 0.4kg	neutral
돼지고기 소비량이 지난해 또 사상 최고치를 기록했다	positive
최근 농촌경제연구원은 지난해 1인당 돼지고기 소비량이 24.5	neutral
증가하며 최고치 경신을 이어가고 	positive
농경연은 이 같은 소비 호조가 올해도 이어지면서 24.6	positive
구제역 방역 활동 고삐 죈다	negative
5월까지	neutral
특별방역기간이 종료되는 5월까지 한층 방역을 강화할 계획이라고 밝혔다	neutral
농협 공동방제단을 이달부터 당초 450개에서 540개로 늘려 확대 운영한다	neutral
듯올해부터 내년까지 돼지 가격이 하락할 것으로 전망됐다	negative
도축 마릿수 감소로 다시 상승세로 전환될 것으로 예측됐다	neutral
중장기 돼지 값에 대해 전망했다	neutral
전체 사육마릿수도 늘어 1천70만	neutral
감소한 34만3천톤이 들어올 것으로 전망됐다	neutral
하락할 것으로 예측했다	neutral
이 가격은 생산비(3천700~3천800원 추산) 수준을 웃돈 수준이다	neutral
상반기 돈가를 살펴보면 2월은 4	neutral
형성하다	neutral
학교 급식 재개와 나들이 수요가 증가하는 3	neutral
이상의 가격이 형성될 것으로 예측됐다	neutral
올해보다 더 하락해 연평균 4천281원이 형성될 것으로 내다봤다	negative
사육두수 감소세가 이어지면서 	neutral
이상 시대가 고착화될 것으로 전망됐다	negative
수출 길 열려가공품 검역	neutral
위생 협의를 완료했다고 	neutral
가공한 축산물이다	neutral
양념 혹은 이를 혼합한 방식으로 가공 처리한 제품이다	neutral
축산물 위생 관리 자료와 수출 희망 업체 정보를 제공하는 등 긴밀한 협의를 진행해 왔다는 설명이다	neutral
한돈 생산량 증가로 돼지 값 하락이 우려되는 가운데 이번 필리핀 수출이 동남아	negative
한돈의 시장을 확대시키는 역할을 할 수 있을지 기대되고 	positive
고수올해는 한돈 떨어져 7조원 ‘위태	negative
자리에 오른 것으로 분석됐다	positive
대를 돌파한 것으로 나타났다	neutral
감소한 6조8천740억원으로 전망됐다	negative
자리는 고수할 것으로 예측됐다	neutral
자리로 내려앉은 쌀 생산액이 지속적으로 하락할 것으로 예상돼서다	negative
생산량 감축으로 6천7천억원대로 감소할 것으로 분석됐기 때문이다	negative
몸살을 앓고 	negative
발생하고 있다는 전언이다	neutral
지난해 12월을 기점으로 다시	neutral
행하고 	neutral
농가들이 사양관리에 어려움을 겪고 	negative
지난해 후보돈 판매 두수가 크게 증가하면서 농장 내 면역력이 낮은 초산 비율도 높아진 것이다	positive
출하할 돼지가 예상보다 줄어 	negative
가량 향상시킨다는 목표를 세웠다	positive
25년까지 MSY 23.8두를 달성키로 했다	positive
생산성을 높일 수 있을 것으로 기대하고 	positive
운용함으로써 데이터 공유기반을 마련하고 빅데이터 활용을 점차 확대키로 했다	neutral
5번쨰 기사입니다	neutral
전년비 17	positive
특히 지난해	neutral
차이는 3천여두에 불과한 수준이다	neutral
물론 역대 1월 출하물량으로는 최고치였다	positive
돼지 값이 급락하면서 	negative
각각 하락했다	negative
이후 가장 낮은 수준이다	negative
이처럼 돼지 값이 하락한 것은 무엇보다 출하가 많았던 데다 박피 도축 중단으로 탕박 도매시장 물량이 크게 늘어난 것이 첫 번째다	negative
수요도 신통치 못했던 것으로 풀이된다	negative
많은 돼지가 사육되는 것으로 조사됐다	neutral
닭 축사지도’를 발표했다	neutral
이 자료는 각 축종별 사육두수	neutral
환경 데이터와의 연계를 통해 입체적인 축산 및 환경 연구 기초자료로 활용할 예정이다	neutral
돼지를 키우며 돼지가 가장 많은 시군은 홍성군	neutral
냄새 분뇨에다 품질까지 먹칠 하나	negative
지난 1일부터 비육돈 구제역 2	neutral
이후 한돈에서 이상육 발생이 크게 증가할 것으로 우려되고 	negative
구제역 백신 접종 횟수는 해당 백신의 품목 허가된 접종방법에 따를 것을 법으로 명시했다	neutral
접종해야 된다	neutral
신뢰 하락이 우려되고 	negative
가령 한 양돈조합의 이상육 발생 현황 조사에 따르면 2015년 1	neutral
이는 전년 12월 구제역 발생으로 발생 지역 및 인근지역 구제역 백신 일관 접종 실시에 따라 이상육 발생 비율도 이 기간 동안 2배 이상으로 증가한 것이다	neutral
전문가들은 우려하고 	negative
감소연초부터 수입 돼지고기가 국내 시장에 대량으로 쏟아져 들어왔다	neutral
최근 식품의약품안전처에 따르면 1월 돼지고기 수입검사 물량은 4	neutral
각각 늘었다	neutral
수입량이 4만톤대를 기록한 것은 지난 15년 3월	neutral
수입이 급증한 것은 수입육에 대한 수요가 주요 원인으로 분석된다	neutral
가량 줄었다	negative
감소했다	negative
가격이 안정적으로 형성되고 	positive
부위별 수입량을 보면 앞다리가 1만7천톤으로 삼겹살	neutral
넘는 물량이 들어왔다	neutral
감소했다	neutral
축산관련단체협의회가 미허가 축사 폐쇄를 담은 가축분뇨법이 국민의 기본권을 침해하는 법률이라며 헌법 소원을 제출했다	negative
헌법재판소를 방문해 ‘가축분뇨법 위헌 소송	negative
않는 규제로 적법화 진행이 불가해 이는 명백히 국민의 기본권을 침해하는 위헌 법률이라고 주장했다	negative
발생 줄다 다시 늘어	negative
다	neutral
폭발적으로 발생 후 감소하는 추세이긴 하나 15년 105건	neutral
근절이 쉽지 않은 상황으로 파악되고 	negative
공식통계를 크게 웃돌 것이란 게 검역본부의 설명이다	neutral
6번쨰 기사입니다	neutral
NULL7번쨰 기사입니다	neutral
근접하는 수준까지 끌어올린다는 목표가 설정됐다	neutral
식품산업 발전계획을 통해 돼지고기의 자급률을 78.6	neutral
국내 돼지고기 자급률은 수입량 증가로 지난 13년	neutral
이에 돼지고기 자급률을 현재보다 7	neutral
비해 하향 조정된 수치다	negative
소폭 낮아졌다	neutral
소비 증가 등을 반영했다는 설명이다	neutral
P 낮춰 잡았다	neutral
정책적 지원을 해야 한다고 	neutral
향상시킨다는 목표도 제시했다	positive
값 강세에 취했나	negative
적자 경영 속출 우려	negative
한돈 강세에도 한국 양돈장 생산 성적은 오히려 퇴보했다	negative
향후 돈가 하락 시 농가들의 경영 압박이 우려되고 	negative
이상을 기록하며 호황을 이어갔다	positive
양돈장 성적은 오히려 퇴보한 것으로 나타났다	negative
△모돈 회전율=2.18회 △복당총산=10.88두 △복당이유	neutral
두에서 오히려 0.2두 하락한 것으로 나타났다	negative
개선되지 못하고 	negative
각종 호흡기 질병 다발로 폐사가 많은 때문으로 풀이된다	negative
비교적 높은 돈가에도 불구 수익성도 그리 높지 않은 것으로 분석되고 	negative
적자 경영 전환도 우려되고 	negative
해결해야 할 것으로 지적되고 	negative
돼지 등급판정 성적이 전달보다 떨어졌다	negative
출하물량으로는 최고를 기록했다	positive
등급판정 성적은 신통치 못했다	negative
차지하면서	neutral
등급 이상 출현율은 63.8	neutral
하락하면서 등급판정 성적이 뒷걸음질 쳤다	negative
중요해지고 있다고 지적하고 	negative
노력을 경주해야 한다고 강조하고 	neutral
8번쨰 기사입니다	neutral
↑전문	neutral
과반 차지국내 종돈 생산 기반이 확대되고 	neutral
증가한 것으로 조사됐다	neutral
종돈 수입을 크게 늘리고 12곳의 신규 종돈장이 들어섰기 때문으로 풀이된다	neutral
세부적으로 살펴보면 국내 종돈장이 사육하고 	neutral
눈여겨 볼 점은 국내 12개 GGP 전문 농장들의 순종돈 사육두수가 총 8천120두로 국내 전체에서 차지하는 비중이 49.5	neutral
천344두로 전체 비중의 55.8	neutral
전문화 추세와 맞물려 매년 증가할 것으로 예측되고 	neutral
2월까지 종돈 수입 ‘제로’올해 2월말까지 종돈수입두수가 ‘제로	neutral
종돈 수입 급증세가 주춤했다	neutral
이유로 한시적으로 수입이 주춤한 것으로 풀이했다	negative
금년 수입 두수는 작년(4천409두)보다는 줄어들 것으로 전망했다	negative
한편 최근 2년간 종돈수입이 급증한 배경에는 고돈가로 인한 종돈 수요증가	neutral
탕박 등급제 정산을 전면 실시할 것을 결의했다	neutral
양돈농가와 적극 협의해 추진키로 했다	neutral
단계 크게 성장하는데 	positive
조직력을 강화해 나가기로 했다	positive
이를 위해 전국적인 지역별 조직화와 1사 1회원 가입운동을 전개하며	neutral
히 수렴키로 했다	neutral
정부와 적극 협의 추진키로 했다	positive
정부가 종합 관리 대책을 내놨다	neutral
카자흐스탄 접경지역인 사육돼지(17년 7월6일)에서 발생했다	neutral
유입 가능성이 상존하고 	negative
아프리카돼지열병 예방 관리대책’을 발표했다	neutral
항만 국경검역을 강화키로 했다	neutral
휴대 축산물 등 모니터링 검사를 강화한다	neutral
재입식 요건 등 신속 대응체계를 구축을 담은 SOP(긴급행동지침	neutral
증가자돈 줄고 	neutral
양돈사료량이 크게 증가했다	neutral
늘었다	neutral
월별 양돈사료량 중 사상 최대치를 기록했던 지난해 11월 58만톤에 단 1천여톤 못 미치는 양이다	negative
또 1월 양돈사료량 가운데서는 역대 최고치였다	positive
감소한 반면 비육돈용은 33만5천톤으로 일년전보다 무려 22	neutral
번식돈용 사료도 9만9천여톤으로 17년에 비해 5.7	neutral
한편 이달부터 	neutral
변경되는 명칭은 다음과 같다	neutral
이상으로 끌어올릴 수 있다는 주장이다	neutral
다산 모돈에 최적화한 시설과 환경연구	neutral
모돈을 다산 모돈으로 정의할 수 있다	neutral
)까지 끌어올릴 수 있다	positive
농장 생산성을 악화시킬 수 있어 세밀한 관리가 요구된다	negative
사육환경을 최적화할 것을 주문했다	neutral
체형관리를 실시할 것을 당부했다	neutral
종부를 실시하는 것이 바람직하다고 	neutral
양돈장 계속 할지 팔지	neutral
높은 가격 제시에 농가 마음 ‘흔들	negative
요즘 고민에 빠졌다	negative
거액의 매매금을 제시 했기 때문이다	neutral
후계자도 있어 농장을 매매할 생각은 추호도 없었다	positive
마음이 흔들리고 	negative
양돈업 미래도 불투명하기 때문이다	negative
이에 따	neutral
어려운 가운데 기존 양돈장의 가치가 점점 높아지고 	negative
농촌경제연구원에 따르면 지난해 1인당 돼지고기 소비량이 24.5	neutral
평균 4천802원의 높은 가격을 형성했다	positive
기업들도 호시탐탐 생산 분야 진출을 엿보고 	neutral
부채가 많은 농장 등 운영이 어려운 농가를 인수하려는 움직임이 포착되고 	negative
최근에는 시세보다 높은 가격을 제시하면서까지 농가들의 마음을 흔들고 	positive
접근해 농장을 팔 것을 권유하고 	neutral
접촉해 농가들을 흔들고 	negative
농장 인수에 주력하고 	neutral
하고 우려했다	negative
산업 호조 이면에 기업의 생산 분야 진출 확대도 불거지면서 	positive
예의주시하고 	neutral
기업에 종속될 수밖에 없다고 	negative
한번 입증됐다	positive
출하물량 증가에도 지난해 말 기준 한돈 재고가 감소한 것으로 조사됐다	negative
감소했다	negative
연속 감소했다	negative
연속 사상 최고를 기록한 가운데 이처럼 재고는 준 것이다	negative
값이 강세를 형성한 이유를 설명하고 	positive
부위별로 보면 후지가 1만1천여톤으로 일년전과 견줘 58	neutral
재고량도 가장 많고 	neutral
재고량이나 증가폭에 있어서 후지의 뒤를 이었다	neutral
가량 늘었다	neutral
감소하면서 전체 재고량 감소에 한 몫 했다	neutral
줄었다	neutral
9번쨰 기사입니다	neutral
출하 작년보다 많았다	neutral
하락2월까지 출하두수가 작년보다 늘었다	negative
각각 감소했다	negative
출하가 준 것은 설 연휴가 지난해는 1월	neutral
지난해는 7만여마리로 올해가 더 많다	neutral
가량 많았다.	neutral
하락했다	negative
긴장돼알젠틴 생산 저조와 환율 불안올 상반기 국내로 들어오는 사료원료 가격이 상승세를 보일 전망이다	negative
최근 농촌경제연구원은 국제곡물 3월호를 통해 1분기 사료용 곡물 수입단가 지수는 80.1로 전분기	neutral
더 오를 것으로 전망했다	neutral
국제 곡물 가격이 오르기 시작한 올 1월 이후 구매한 물량이기 때문이다	neutral
오를 것으로 점쳐지고 	neutral
83.8)에 비해서는 낮은 수준이기는 하나 최근 국제 곡물시장의 흐름을 보면 긴장을 늦출 순 없다	negative
콩 가격의 상승과 미국의 밀 작황 부진 등에 따라 강세를 형성하고 	negative
오르고 2분기는 198.2로 1분기보다 2.3	neutral
가격 상승 가능성도 있다고 지적했다	negative
가격 하락 전망에도 농가들의 모돈 사육 의향은 높은 것으로 나타났다	positive
상승한 것으로 조사됐다	neutral
가격이 올해 하락세이나 생산비 이상으로는 유지할 것으로 전망됐기 때문으로 풀이된다	neutral
이를 뒷받침하듯 올해 후보돈 판매 두수도 크게 늘었다	neutral
이동 등록 현황을 보면 올해(1~2월) 이동(판매)두수는 총 3만180두로 작	neutral
증가했다.	neutral
총 사육두수 1천1백만두 근절이 예상되고 	positive
화농 탓	neutral
목살 가격이 하락 일로에 처했다	negative
부위들 중 가장 하락폭이 컸다	negative
연속 하락했다	negative
가까이 가격이 떨어졌다	negative
주목받게 된 것이 한 원인으로 파악되고 	neutral
있는 목심 부위 화농도 한 원인	negative
지속적으로 해당 문제가 이슈화되고 있어 목심 가격 회복을 더욱 어렵게 하고 	negative
대책 마련이 필요하다고 	negative
양돈농가들의 반감이 커지고 	negative
농림축산식품부는 지난해	neutral
패러다임을 전환하는 가정에서 일부 시설 용어 역시 전환하며	neutral
용어 변경을 농축산부에 촉구 하고 	negative
순화된 용어로 변경해 사용할 것을 요구하고 	neutral
약세 지속향후 돼지 값은 출하두수가 증가하면서 전년 대비 약세가 지속될 것으로 전망됐다	negative
하락할 것으로 내다봤다	negative
지난해 수준을 회복하지는 못한다는 것이다	negative
지난해보다 낮은 수준을 형성할 것으로 예상했다	negative
따른 결과라고 설명했다	neutral
증가한 671만마	negative
기록할 것으로 추산했다	neutral
모돈 입식 증가로 돼지 사육두수도 지속적으로 지난해보다 많은 수준이 유지될 것으로 전망됐다	neutral
많을 것으로 내다봤다	neutral
가량 감소한 16만톤을 기록할 것으로 전망됐다	negative
PED 강타	negative
돼지 질병의 창궐이 경고되고 	negative
여름 출하가 예상만큼 늘지 않을 수 있다는 전망이 나올 정도다	neutral
이 같은 우려가 나오고 	negative
-2℃로 평년 대비 1.7	negative
특히 온도가 낮을수록 기승을 부리는 PED	negative
더 심각한 수준이라는 진단이다	negative
문제는 PED 그 자체도 많은 폐사를 유발하지만 	negative
이 같은 돼지들이 현재 어느 해보다 많다는 것이다	negative
거기다 최근 비육돈 사육	neutral
위탁장이 차지하는 비중이 높아진 것도 한 원인으로 지목된다	neutral
질병에 더욱 취약하다는 것이다	negative
될 것이라고 지적했다	negative
가량은 이렇듯 열악한 위탁장에서 길러진다는 얘기다	negative
호흡기 질병을 비롯한 각종 질병이 폭발적으로 증가할 위험이 높다는 지적이다	negative
당부하고 	neutral
10번쨰 기사입니다	neutral
돌파양돈장 다산돈 관리 체계로 전환을국내 다산성 종돈 보급이 확대되면서 최근 모돈 성적도 가파르게 상승하고 	neutral
종돈업계에 따르면 지난 2010~11년 구제역 파동으로	negative
만두 이상이 매몰됐다	negative
종돈 수입도 예년보다 크게 늘리면서 2011년 7천171두	neutral
이 중 다산 능력을 보유한 유럽 종돈이 본격적으로 들어오기 시작	neutral
이후부터 국내 양돈장에도 다산형 모돈이 보급된 것으로 추정되고 	neutral
종돈물량은 모두 다산성 모돈이다	neutral
종돈장 모돈 성적도 매년 가파르게 향상되고 	positive
요크셔 모돈의 평균 산자수는 12.2두인 것으로 집계됐다	neutral
두가 늘어난 것이다	neutral
감안하면 약 2배 상승한 수치다	neutral
있는 여건에서 개별 양돈장들은 다산 모급에 맞는 차별화된 관리로 속히 전환해야 한다고 	neutral
대를 위협받고 	negative
삼겹살 생산량도 증가했다	neutral
이상 하락했다	negative
한돈 삼겹살 점유율을 살펴보면 	neutral
52.2%	neutral
한편 지난해 한돈 부위별 점유율은 	neutral
국내 소비자들의 선호 부위가 아니라 수입량도 미미하다	neutral
삼삼데이 실종	negative
양돈시장 침체 전조	negative
돼지 값 흐름이 심상치 않다	negative
향후 양돈시장 침체의 전조가 아닌지 우려되고 	negative
이맘때 양돈시장은 삼삼데이 수요로부터 힘을 받아 상승한 후 그 여세가 본격적인 고돈가 시기까지 이어져 왔다	neutral
가량 떨어졌다	neutral
(4천506원→4천567원) 올랐으며 16년 역시 같은 흐름을 보였다	neutral
지난 8일 4천원대도 무너졌다	negative
이처럼 올해 돼지 값이 약세를 보이는 것은 공급물량 증가가 첫 번째 원인이다	negative
2월까지 돼지 출하두수가 295만마리로 지난해 대비 7	neutral
예상됐던 수입량도 2월말 현재 7만9천여톤으	neutral
늘었다	neutral
대략 따져 봐도 2월까지 수입산을 포함한 돼지고기 공급량은 15만8천여톤으로 지난해 유통보다 8	neutral
동시에 대체 소비 변수가 사라진 것도 무시할 수 없다	neutral
시작으로 그동안 생산량 증가에도 고돈가가 지속될 수 있었던 주요 원인 중 하나가 대체수요였다	neutral
지난해 살충제 계란 파동 등이 그렇다	negative
올해는 이 같은 대체 소비 변수들이 없다	neutral
돼지 값 상승에 더 많이 기여했다고 	positive
대체 수요의 효과를 무시할 수 없는 것이다	negative
최근의 침체된 양돈시장의 반전을 도모할 수 있는 대책 마련이 시급하다고 	negative
지난해 돼지 값 호조에다 농가당 평균 출하두수도 늘어 양돈농가들은 수익을 극대화한 것으로 분석되고 	positive
증가한 것으로 나타났다	positive
증가했다	neutral
늘었다	positive
이에 따라 지난해 생산비가 16	neutral
가정할 경우 작년 각 농가들은 돈가 호조	positive
지자체 불가 판단 시 행정처분 우려	negative
축산업 구조조정의 신호탄이 될 것으로 우려되고 	negative
정부는 최근 부처 합동으로 미허가 축사 적법화 이행 기간 운영 지침을 발표했다	neutral
적법화 대상 농가는 이달 24일까지 ‘간소화된 적법화 허가 신청서	neutral
제출된 이행계획서는 각 지자체에서 평가하여 농가별로 적법화 이행 기간을 최대 1년간 부여 하게 된다	neutral
적법화에 필요한 충분한 이행 기간을 부여하겠다는 것이다	neutral
축산인들의 생각은 다르다	neutral
지적했다	negative
향후 행정처분 근거가 될 수 있다는 것이다	neutral
축산업 생산현장의 구조조정이 일어날 것이라고 한 목소리를 내고 	negative
돼지고기 수입 2월도 늘었다	positive
3만8600톤 전년 대비 6	neutral
↑	neutral
돼지고기 수입량이 1월의 증가세를 이어받았다	neutral
감소했다	negative
지난해 동월 3만6천톤에 견줘서는 6.9	neutral
기준 수입량은 7만8천800여톤으로 일년전 7만2천톤에 비해 9.5	neutral
그동안 돼지 값이 강세를 형성하면서 	neutral
가량 감소한 통계치가 이를 입증하고 	negative
특히 삼겹 이외 가공용 부위에서 수입량 증가가 두드러지게 나타나고 	neutral
지난해 동월 1만4천600여톤에 견줘서는 무려 26.7	neutral
이에 2월말까지 수입량은 지난해 같은 기간보다 31	neutral
)가 급증했다	neutral
감소했다	neutral
지난해와 비슷한 수준에 그쳤다	neutral
축산물 수출 전국 1위로 우뚝작년말까지 130만 달러 달성서귀포시축협	positive
조합으로 집계됐다	neutral
수출을 달성한 것으로 집계했다	positive
수출을 많이 하는 조합으로 거듭나고 	positive
파견해 다양한 프로모션 마케팅을 전개해 나갈 방침이라고 밝혔다	neutral
발생 여파로 이유 전 자돈 폐사가 증가하고 	negative
최근 1년간 가장 낮은 것으로 나타났다	negative
폭염이 지속된 6~7월보다도 낮은 것으로 분석됐다	negative
이 같이 배경에는 최근 일부 지역에서 발생하고 있는 PED의 영향으로 추정되고 	neutral
대책으로 이를 최소화한다는 방침이다	neutral
자조금관리위원회는 지난 15년부터 농가 거출금 두당 200원을 추가 거출해 한돈 수급안정예비비를 적립	neutral
이 같이 적립된 수급	neutral
수급 안정을 위해 사용될 계획이다	positive
가격 안정 대책을 시행한다는 계획이다	neutral
수급비를 적시에 활용할지 관심이 모아지고 	neutral
최근의 돼지고기 소비 침체를 짐작케 하고 	negative
떨어졌다	neutral
1천842원)에 견줘서도 낮은 수준이다	negative
강추위 여파로 구이용 부위의 소비가 부진했던 것도 한 원인으로 지적되고 	negative
15~16년과 견줘서는 높은 수준을 형성하고 	neutral
11번쨰 기사입니다	neutral
축산업 근로시간단축 적용서 제외축산농가의 경우 근로시간 단축 적용이 제외된다	neutral
안)이 가결됨에 따라 앞으로 근로자 주당 최대 근로시간이	neutral
8시간에서 52시간으로 단축됐다	positive
해당되지 않는 것으로 나타났다	neutral
농가도 적용이 제외되는 것이다	neutral
현장의 농가들이 혼란을 겪지 않도록 전국 지부에 이 같은 내용을 담은 홍보물을 배포키로 했다	neutral
소비와 연관도올해 돼지 값이 불안한 출발을 보이고 	neutral
등락흐름이 상당부분 겹치는 모습을 보였다	neutral
원서 4천720원으로 역시 상승했다	neutral
이 같은 일치된 흐름을 보였다	neutral
모두 가장 낮았다	neutral
비슷했다	neutral
연말로 갈수록 다시 하락하는 패턴을 보였다	negative
그리고 1~2월 고용률	neutral
이후 연속 하락했는데 돼지 값 역시 지난해 11월(4천507원) 이후 내림세다	negative
취업률 등 고용관련 지표가 보이는 일정한 계절적 흐름이 돼지 값의 계절적 흐름과 일치한다는 점 때문이다	neutral
탓에 실업률도 올라가는 것이다	negative
연중 일정한 등락을 보이는 것이다	neutral
고용률과 시중 경기의 연관성도 이 같은 현상을 설명하는 하나의 요인으로 보인다	neutral
이상 급증했으며 동시에 사상 최고치를 기록했다	positive
발효 전 평년	neutral
미국산 돼지고기 수입량만 보면 역대 최고치며 전체 수입량 중 37	positive
가공용 식품 원료육 수입이 많았던 때문이라는 설명이다	neutral
앞다리였다	neutral
여기에 FTA 효	neutral
도 한 몫 했다	neutral
미국산 돼지고기 수입 단가를 보면 발효 전 평년에 	neutral
원서 지난해 2천958원으로 오히려 하락했다	negative
발효 효과에 의해 상쇄된 것이다	neutral
향후 이처럼 무관세가 계속되는 가운데 가격 경쟁력은 더 높아질 전망이다	positive
수입 단가가 하락하면서 미국산 수입 증가세가 이어질 가능성이 크다고 	negative
국내보완대책의 실효성을 제고해 경쟁력 제고에 힘써야 한다고 	neutral
점유율 제고에 나서고 	positive
전망 등에 대해 발표했다	neutral
유럽과 가격 경쟁력에서도 우위를 점하게 돼 올해 수출량도 작년 대비 5	positive
측됐다	neutral
스페인의 이베리코 같은 고품질 돈육 수출을 위한 전략도 세우고 	positive
아시아로의 수출량을 늘릴 것으로 전망되면서 	positive
한돈과 수입육의 증감이 엇갈렸다	neutral
기준 한돈 재고량 추정치는 4만1천톤으로 각각 3만4천톤씩을 기록한 전달과 지난해 동월에 견줘 20	neutral
수요 부진으로 재고가 는 것이란 설명이다	negative
특히 이 가운데 삼겹살이 1만여톤이 쌓여 일년전보다 무려 95	neutral
재고로 쌓여 12월에 비해 20	neutral
수입량이 전달보다 34	neutral
가량 적었다	neutral
1월 수입량은 일년전에 견줘서도 12	neutral
증가하면서 적체가 가장 심했다	negative
감소했다	negative
한돈은 상대적으로 소비가 저조했다는 사실을 짐작케 하고 	negative
12번쨰 기사입니다	neutral
행락철이 다가오면서 조금씩 살아나고 	positive
대비 오름세로 시작한 이후 연속 상승	neutral
22일 현재 4천188원까지 오른 상태다	neutral
나들이철 수요에 대비하려는 시장의 움직임이 반영된 것으로 풀이된다	neutral
가량 낮은 수준이다	negative
돼지 값이 5천원을 넘기기 어렵다는 분석이다	negative
정점을 찍은 뒤 7월부터 하락할 것으로 전망했다	neutral
9월은 4천600~4천900원으로 예상했다	neutral
증가할 것으로 예상해서다	neutral
발생 정도에 따라 변수가 될 것으로 지적했다	neutral
수입육 2배 ↑	neutral
있는 국내 돼지고기 소비량이 수입산에 의해 채워지고 	neutral
늘었다	neutral
1인당으로 따져보면 13년 20.9	neutral
이후 국내 돼지 값이 강세를 형성할 수 있었던 것은 이처럼 빠르게 늘어난 소비의 효과라 해도 과언이 아니다	positive
그쳤다	negative
그쳤다	neutral
한돈 증가분으로는 늘어나는 소비를 감당하지 못했다는 얘기다	negative
이를 차지한 것은 수입육이었다	neutral
돼지고기 수입량은 지난해 37만톤으로 2배가 됐다	neutral
돼지고기 수입량은 5만여톤이 늘었다	neutral
올해 돼지 값 약세를 형성하면서 소비를 살려야 한다는 목소리가 높아지고 	negative
초점을 맞춰야 한다는 지적이 설득력을 얻고 	negative
노력도 병행돼야 한다고 	neutral
성폭력 근절대책의 일환으로 농축산업 분야 등 여성 외	neutral
인 노동자 고용 사업장을 대상으로 집중 점검이 진행된다	neutral
집중 점검키로 했다	neutral
농축산업 분야 사업장이라는 설명이다	neutral
근로환경 외에 여성 외국인 노동자의 성희롱	neutral
또 사업장 점검 시 통역원이 동행해 여성 외국인 노동자와 면담을 진행해 근무 실태와 고충 파악을 병행할 예정이다	positive
발병 가능성 미리 차단하세요	neutral
외국인 노동자들의 밀반입 축산물 유입 방지 등 검역 강화가 유일한 대책임이 다시 한 번 주장됐다	neutral
집중 논의했다	neutral
잔존한 열병 바이러스에 의해 전	negative
될 확률이 가장 높다	neutral
강화할 필요가 있다고 	neutral
모니터링이 중요하다고 	neutral
파괴된다는 보장이 없기 때문에	negative
13번쨰 기사입니다	neutral
지난해와의 차이는 크게 벌어졌다	negative
돼지 도매시장 경락가격은 줄곧 3천원	neutral
하순 계절적 수요가 살아나면서 3천원대 탈출에는 성공한 것이다	positive
하락하면서 전년 대비 약세를 이어갔다	negative
출하가 증가한 가운데 소비도 받쳐주지 못했던 때문이다	negative
전까지 출하된 돼지는 일평균 7만3천여마리로 일년전 6만8천여마리 대비 무려 6	neutral
총 출하두수 차이는 크지 않을 것으로 추산된다	neutral
여지 높아 불안미국과 중국의 무역전쟁이 시작된 가운데 그 불똥이 우리나라 양돈시장에까지 튈 가능성이 제기되고 	negative
사건의 발단은 미국이 지난달 중국산 철강	neutral
추가 관세부과 방침을 밝힌 것이다	neutral
미국의 돼지 값 하락이 불가피하게 됐다	negative
나라간 무역 전쟁이 우리나라 양돈시장까지 위협하게 된 이유다	negative
미국의 돼지 값 하락의 결과로 우리나라는 미국산 돼지고기 수입량 증가와 미국산 돼지고기의 점유율 확대가 우려되기 때문	negative
중국과 홍콩으로 수출돼 멕시코 다음으로 높은 비중을 차지했다	neutral
중국의 관세부과 조치가 미국 양돈업계에 미칠 여파가 큰 셈이다	negative
급락	negative
반응하고 있다는 지적이다	negative
중국의 발표대로 추가 관세가 현실화될 경우 미국의 돼지 값 하락은 더 가속화되면서 	negative
수입을 부추길 수 있는 변수다	negative
가량 증가할 것으로 추산하고 	positive
중국 수출이 관세 장벽에 부딪히고 생산량까지 늘 경우 미국 돼지고기는 다른 시장을 찾을 수밖에 없다	negative
관세가 없어 접근이 더욱 쉬운 시장이다	positive
중국과 미국 사이 무역전쟁이 어떻게 전개될지가 향후 국내 양돈시장에도 주요 변수가 될 수 있는 만큼 주의 깊게 그 추이를 지켜볼 필요가 있다는 지적이다	neutral
가격 관계없이 늘 것	neutral
한돈 시장을 위협하고 	negative
이 같이 진단했다	neutral
가격에 상관없이 수입을 지속적으로 늘릴 것	positive
.	neutral
한돈 시장을 위협하고 	negative
이 같이 수입 업체들의 한국 시장 공략 전략은 가격 대비 최대의 효용을 추구하는 소비자들의 구매 패턴을 파악했기 때문이다	neutral
향후 한돈 점유율 하락이 우려되고 	negative
↓	negative
상승기에 접어들 것으로 관측됐다	neutral
평년 대비로도 돈가 상승은 억제될 것으로 보인다	neutral
오를 것으로 내다봤다	neutral
봄철 상승기에 접어들 것이란 전망이다	neutral
평년	neutral
약세가 예상됐다	negative
낮을 것으로 관측됐다	neutral
제외하고는 올해 예상 돈가가 평년 대비로도 모두 낮다	neutral
고돈가 시기에 비해 어려운 시장이 예고되고 	negative
이는 무엇보다 돼지 출하물량이 증가한데 따른 것으로 분석됐다	neutral
농경연은 5~9월 돼지 등급판정 두수가 전년 동기보다 1.4	neutral
9월은 1천80만~1천100만 마리로 전년 대비 0.7	neutral
A형 구제역 원인 불명확	negative
경기 김포의 양돈장에서 A형 구제역이 발생했다	neutral
한우)에서 구제역이 발생한 이후 407일만이며 돼지에서의 발생은 16년 3월 이후 2년만이다	neutral
특히 이번처럼 A형 구제역이 돼지에 발생한 것은 국내에선 이번이 처음이다	neutral
세계적으로도 발생 사례가 드물다	neutral
■국내 구제역 발생 일지	neutral
구제역 재발로 시작됐다	neutral
돼지 16만마리가 묻혔다	negative
살처분되는 최악의 피해를 남겼다	negative
그렇게 해를 걸러 재발이 이어지던 구제역은 지난 14년 이후부터는 매년 발생하고 	neutral
기록을 남기게 됐다	neutral
지난해 2월 A형 구제역이 발생한바 있다	neutral
소에서 발생했으며 돼지는 이번이 처음이다	neutral
구제역 발생은 세계적으로도 흔치 않은 것으로 알려졌다	neutral
우리나라와 인접한 중국이다	neutral
농장 간 돼지 이동제한 등을 조치했다	neutral
점이 우려되는 점	negative
단계로 격상하는 한편 발생 지역인 경기도	neutral
전국 돼지에 백신을 접종하고 이후 2차 백신도 추가로 실시할 계획이다	neutral
당장 백신	neutral
시간이 필요한 만큼 확산 가능성이 있어 긴장의 끈을 놓을 수 없는 상황이다	negative
정확한 유입 경로는 아직 밝혀지지 않아 불안감이 더욱 커지고 	negative
↓	neutral
한돈 비싸 업체들 사용 꺼려최근 몇 년간 고돈가가 지속되면서 	negative
P 낮아졌다	neutral
연속 하락한 것이다	negative
증가하면서 원료육 시장이 빠르게 수입산으로 잠식되고 	negative
국산은 가격이 비싸 경쟁이 안 된다고 	negative
두서경양돈 전산농가 분석 결과올해는 작년보다 다소 늘 듯지난해 농가 손익 분기점은 MSY 14.8두로 나타났다	negative
올해는 돈가 하락 전망으로 MSY 손익 분기점은 이보다 높아질 전망이다	negative
전산 경영 분석 농장 모두 흑자	positive
경영을 이룬 것으로 분석됐다	neutral
대부분의 농가가 수익을 올린 것으로 추정됐다	neutral
분석돼 생산성 제고에 많은 노력을 기울여야 한다고 	negative
두로 전년보다 줄어	neutral
크게 감소했다	neutral
연초 수입 물량을 다소 조절한 영향으로 풀이된다	neutral
물량이 계획되고 있는 등 본격적으로 종돈은 수입될 전망이다	neutral
물량이 원활하게 들어올 지는 미지수로 분석되고 	neutral
접종국내선 처음으로 돼지에 A형 구제역이 발생했다	neutral
확산 여부에 촉각을 곤두세우고 	neutral
형의 구제역이 확진됐다	negative
차례 발생한 A형도 모두 소 구제역이었다	neutral
농축산부는 백신 미접종 유형의	neutral
구제역이 발생한 만큼 우선 경기와 충남지역 돼지에 O	neutral
순차적으로 O	neutral
14번쨰 기사입니다	neutral
P ↓	neutral
지난해 돼지고기의 유통비 비중이 낮아졌다	neutral
P 하락했다	negative
유통비용률은 소비자가격 중 농가 수취가격을 제외한 나머지 유통비용이 차지하는 비중이다	neutral
각각 상승했다	neutral
수입 돼지고기 유통비용률도 감소했다	positive
p 감소했다	negative
가격 상승에다 판매가 부진해 유통업체들의 이윤이 감소했기 때문으로 풀이됐다	negative
하락했다	neutral
이상 떨어졌다	negative
증가했다	positive
예견됐던 증가세였다	neutral
월별로 보면 1월 출하가 160만마리로 일년전보다	neutral
감소했다	negative
발생한 구제역에 따라 이동제한이 실시된 영향이다	neutral
지난해보다 돼지 출하가 적었던 셈이다	negative
돼지 값은 약세가 이어졌다	negative
하락했다	neutral
낮았다	neutral
동시에 소비도 침체됐던 때문으로 분석되고 	negative
같은 양돈시장에 호재로 작용하던 외부 변수들도 없어 돼지 값 하락을 피할 수 없었다	negative
예측을 어렵게 하고 	negative
지난해와 견줘서는 모두 하락할 것으로 내다봤다	negative
무엇보다 돼지 출하가 많을 것이란 게 주요 이유다	neutral
돼지 출하 두수조차 장담하기 어렵게 됐다	negative
최근 올해 돼지 출하가 예상보다 적을 수 있다는 전망이 나	negative
고 있어서다	neutral
탓에 자돈 폐사가 많았기 때문	negative
가량 감소한 것도 이를 뒷받침한다는 지적이다	negative
공급물량 감소 가능성만 있는 것은 아니다	neutral
수입량도 예상을 빗나갈 수 있다는 신호들이 나타나고 	negative
미국 돼지 값 하락이 예상되고 	negative
이와 상관없이 올해 중국의 돼지고기 수입량 감소와 미국 등의 돼지고기 생산 증가가 전망되고 	neutral
우리나라 돼지고기 수입이 증가할 여지가 높아지고 	neutral
소비 측면에서 불안을 부르는 변수들도 있다	negative
지방선거가 치러진다	neutral
제한되는 만큼 소비 침체 분위기를 더욱 심화시킬 가능성이 있다	negative
소비에 찬물을 끼얹을 수 있어 우려되고 	negative
최근 발생한 돼지 구제역은 그 여파를 더 짐작하기 어려운 변수다	neutral
시장의 반응 등이 가늠하기 어려워서다	negative
특히 질병은 그 발생 여부조차 예측 불가능하다는 점에서 시장의 불확실성을 높이는 변수로 더욱 요주의 대상이 된다	negative
문제는 이처럼 올해 돼지 값 약세가 지속되는 가운데 예측마저 어려운 시장이 전개되면서 양돈농가의 경영 불안은 더욱 커진다는 점이다	negative
이에 농가들	neutral
요구되고 	neutral
돼지고기 수입 브레이크가 없다	negative
월 수입 7년만에 5만톤 넘어1분기 13만톤 전년비 18	neutral
각각 증가했다	neutral
전년 대비 4.3	neutral
월간 돈육 수입량이 5만톤을 넘은 것은 근 7년만이다	neutral
점을 감안하면 3월 수입량이 실질적인 역대 최고치인 셈이다	positive
이로써 1분기 돼지고기 수입량은 13만톤으로 일년전 11만톤 대비 18	neutral
그동안 계속됐던 고돈가에 수입육이 시장을 넓혀온 것으로 파악되고 	neutral
삼겹살 외 가공용 부위들이 올해도 전체 수입량 증가를 견인했다	neutral
삼겹살(1만7천톤)을 크게 웃돈 것은 물론 전체 수입량 중 절반 이상을 차지했으며 뒷다리	neutral
증가하면서 전체 수입량 가운데 47.5	neutral
반면 삼겹살은 4만7천톤으로	neutral
년전보다	neutral
)로 떨어졌다	neutral
전체 증가율에는 못 미쳤다	negative
급증했다	neutral
미국산 증가세가 두드러졌다	neutral
감소했다	negative
김포서 또 구제역	neutral
지원돼지 A형 구제역이 추가로 발생했다	neutral
경기 김포 하성면 양돈장에서 구제역 항원이 확인돼 농림축산검역본부에서 정밀 검사한 결과 혈청형 A형으로 확진됐다고 	neutral
의견을 수렴한 결과 추가 검출 원인이 김포지역에 바이러스가 남아있는 것으로 추정됨에 따라 추가 방역 조치키로 했다	negative
접종 시기를 당초 계획(24~26일)보다 당겨 오는 20일 실시키로 했다	neutral
강화는 김포를 거쳐야만 내륙으로 이동이 가능한 지역적 특성이 고려된 것이다	neutral
강화군은 16일까지로 일주일 더 연장된다	neutral
김포시는 발생지역인 만큼 긴급행동지침에 따라 이동제한 조치가 유지된다	neutral
강화지역 돼지농장 일제 청소 및 특별 소독 캠페인	neutral
실시하고 김포시에 긴급 가축방역비 1억원을 긴급 지원했다	positive
농가 생산 성적이 올해는 전반적으로 상승하고 	positive
생산성적은 작년과 비교해 향상된 것으로 나타났다	positive
두로 작년과 비교해 소폭 상승한 것으로 나타났다	neutral
두로 지난해에 비해 상승했다	positive
분기 성적은 전반적으로 전년도 동분기 보다 향상될 것으로 예측되고 	positive
매출 비중이 매년 낮아지고 	negative
수입 돈육 매출 확대와 연관이 있는 것으로 추정되고 	neutral
저지방 50.3	neutral
저지방 51.2	neutral
저지방 51.6	neutral
지난 2014년 하반기 이후 ‘웰빙 붐	neutral
일어나면서 	positive
수입 돈육 대체와도 연관이 있는 것으로 추정되고 	neutral
수입 돼지 매출 구성비는 매년 성장하고 	positive
소비자들이 가격 대 성능비가 우수한 냉장 수입 삼겹살로 구매를 대체하고 	positive
15번쨰 기사입니다	neutral
분기 수입육의 시장 잠식은 더 심화됐다	negative
밑돌았다	negative
늘었다	positive
연속 사상 최고를 기록하게 된다	positive
수입량은 더 크게 늘었다	neutral
1분기 돼지고기 수입량은 일년전 11만톤 대비 18	neutral
수준에 그쳤다	neutral
분기만 보면 돼지고기 자급률은 70	neutral
하락했다	negative
소비 침체에다 증가한 한돈 생산이 돼지 값 하락의 원인으로 지목되고 	negative
이 같은	neutral
원인을 의심케 하고 	negative
중국의 수입 감소로 세계 돼지 값 하락이 점쳐지고 	negative
가능성이 높아지고 	positive
중요해지고 	neutral
번식 ↑ 자돈 ↓1분기 양돈사료량이 지난해보다 5	neutral
늘었다	neutral
참조> 1~2월에 이어 3월 역시 역대 동월 양돈사료량으로는 역대 최대치다	negative
올해 양돈 사료량은 사상 최고치를 기록할 것으로 보인다	positive
이로써 1분기 양돈사료량은 일년전보다 5.2	neutral
늘었다	neutral
감소했다	neutral
원료값 급등	positive
호소올해 돼지 값이 약세를 형성하는 가운데 사료 가격 인상도 예고되고 	negative
대두박 가격이 지난 1월 톤당 403	neutral
이달 중순 현재 490달러까지 치솟았다	neutral
3월 229달러까지 올랐으며 이달 230달러대를 유지하고 	neutral
올랐다	neutral
아르헨티나의 가뭄이 주요 원인으로 꼽히고 	neutral
남미산이 차지하는 대두박의 경우 그 직격탄을 맞아 가격이 급등하고 	negative
가격 인상 요인이 발생한 상태	neutral
최근 원화 강세가 지속됐지만 원료가격 상승분을 상쇄할 정도는 아니라는 설명이다	neutral
시기와 인상폭을 저울질하는 단계인 것으로 파악되고 	neutral
안 될 정도로 곡물 가격이 치솟았다	neutral
지금과 같은 강세가 유지될 것으로 전망되고 	positive
가격 상승을 유발할 수 있다는 점이 불안 요인으로 분석되고 	negative
  양돈업 피해 가장 커산자부  연간 708억원 손실	negative
났다	neutral
우리나라의 농축산물 생산액이 연평균 1천951억원 감소했다	negative
가량 감소했다는 것이다	negative
특히 이 가운데 축산업 피해가 연평균 1천195억원으로 농업 전체 피해 가운데 61.2	negative
양돈분야의 생산액 피해는 전체 우리나라 농업 피해의 36.3	negative
품목에 비해 빠르게 인하돼 영향이 큰 것으로 보인다고 	neutral
미국에서 수입되는 돼지고기의 주요 부위들은 지난 16년부터 무관세로 들어오고 	neutral
관세가 부과되고 	neutral
밑도는 수준이라고 지적하면서 	negative
보복관세 추진우리 정부가 미국에 대해 보복관세를 추진한다	negative
국내로 수입되는 미국산 제품에 대한 양허정지를 세계무역기구(WTO	neutral
이는 미국의 태양광과 세탁기 긴급수입세한조치	neutral
정부는 미국의 세이프 가드로 인한 한국산 수출품의 추가 관세 부담액이 연간	neutral
억8천만달러(5천억원)에 달하는 것으로 추정하고 	neutral
이에 이와 실질적으로 동등한 수준으로 미국산 수입품에 대해 양허정지를 추진할 계획이며 해당 품목은 추후 통보키로 했다	neutral
한돈 소비가 총체적 난국에 봉착했다	negative
동향분석회의를 개최했다	neutral
호재가 없어 현재 한돈 소비 시장은 ‘총체적 난국	negative
더 이상의 가격 상승은 제한적일 것으로 분석했다	neutral
이들은 내달부터 출하물량이 본격적으로 부족할 것으로 예측	neutral
16번쨰 기사입니다	neutral
모돈 작년보다 늘었다	negative
돼지 사육두수는 지난해보다 증가한 것으로 나타났다	neutral
통계청은 지난 19일 1분기 가축사육	neutral
늘었다고 	neutral
이 가운데 모돈수는 105만8천마리로 12월과 같았으며 지난해 3월에 비해 1.2	neutral
가량 두수가 많다	neutral
이처럼 전체 두수는 늘었지만 	neutral
각각 감소했다	neutral
감소했다	negative
늘었다	neutral
이로써 3월 기준 농장당 사육두수는 1천778마리로 지난해 동월보다 3.2	neutral
↑) △5천마리 이상=355만5천마리(전년비 3.5	neutral
소폭 올랐다	neutral
한편 이번 돼지 사육두수 통계는 표본농가 범위를 기존 농림	neutral
농가와 함께 법인도 포함되면서 기존 통계와 차이가 발생한다고 	neutral
올해는 5천원을 넘기 힘들 전망이다	negative
돼지고기 생산량 증가로 돼지 지육가격은 전년보다 약세를 보일 것으로 전망했다	negative
하락할 것으로 예상했다	neutral
이는 탕박 기준 제주 가격을 포함한 수치로 제주 가격을 제외한다면 이보다 더 하락한 가격이 형성될 것으로 보인다	neutral
출하두수는 139만마리가 예측된다	neutral
수준으로 연중 최고를 형성하다	neutral
전년보다 낮게 형성될 것으로 예측됐다	neutral
들어가는 가운데 수입량만은 예상을 빗나가고 	neutral
가량 적었다	neutral
늘었다	neutral
이렇게 수입이 급증한 것일까	neutral
전망한 이유는 국내 돼지 출하증가와 돼지 값 하락 때문이었다	negative
하락했다	negative
수입이 이처럼 증가한 이유는 수입 부위에서 찾을 수 있다	neutral
값은 하락했지만 전후지 부위는 강세를 보이며 수입산에 대한 수요가 증가한 것이다	positive
상승했다	neutral
급증했으며 뒷다리도 지난해 400여톤서 올해 2천톤을 넘기며 4배 가량 증가했다	neutral
여기다 세계 주요 국가들의 돼지 값 하락도 한몫했다	negative
떨어져 약세를 형성하고 	negative
환율도 받쳐줬다	positive
올해 원화가 강세를 보였다	positive
이 같은 국제 돼지 값 하락과 원화 강세는 수입 가격에 반영됐다	neutral
가량 하락했다	negative
향후 돼지고기 수입 전망도 낙관할 수 없다	negative
국내 수입을 더 부추길 수 있어서다	negative
세계적으로 올해 돼지고기 생산량이 증가하면서 돼지 값이 하락할 것이란 전망이어서 향후 미	negative
17번쨰 기사입니다	neutral
NULL18번쨰 기사입니다	neutral
■4월 한돈 4439원	neutral
하락4월 돼지 값이 올 들어 	negative
지난해 동월대비 하락폭도 가장 컸다	negative
오르면서 	positive
계절적으로 돼지고기 소비가 살아나는 시기인 때문이다	neutral
낮았다	neutral
이후 돼지 값이 전년 대비 낮은 수준이 지속되는 가운데 4월 하락폭이 가장 컸다	negative
비교해 출하가 거의 줄지 않았던데 	neutral
돼지 값 하락폭을 키운 것으로 분석된다	negative
돼지 출하두수가 역대 4월 중 가장 많았다	neutral
증가했다	positive
올해는 그 차이가 크지 않았다	neutral
돼지 출하가 140만마리 이상을 기록한 것은 올해가 처음이다	neutral
초로 출하가 다소 미뤄졌던 때문이다	neutral
출하 증가세가 이어지고 	neutral
이로써 4월말 돼지 출하두수는	neutral
전 561만마리에 비해 4.8	neutral
저작권자 	neutral
양돈타임스 무단전재 및 재배포 금지임정은다른기사 보기 19번쨰 기사입니다	neutral
불을 당겼다	positive
외식 수요 감소에다 최근 구제역까지 발생하면서 한돈 소비 정체가 심각한 상황이라고 분석했다	negative
한돈 소비촉진 행사를 추진키로 해 그 결과에 기대가 모아지고 	positive
컨셉=가정의 달을 맞이해 ‘한돈으로 소확행	neutral
각 부위별 소비처를 세분화에 타깃 프로모션을 진행한다	neutral
각 부위별 수급상황 분석과 대응방안을 모색하는 접근을 시도했다는 점에서 의미가 크다 	neutral
외식 소비가 증가하는 봄철을 맞아 외연을 확대한다는 계획이다	positive
이와 함께 가정의 달을 맞아 한돈	neutral
전부위 소비촉진도 함께 도모한다	positive
맞춤형 소비확대 전략을 실시한다	neutral
소비확대 협조를 요청하는 한편 	neutral
소비 붐업도 적극 추진한다	neutral
진짜 의사가 돌아왔다	neutral
소비촉진 캠페인>을 알리기 위해 네이버	positive
올해 한돈 소비는 정체된 반면	neutral
입 돈육과 수입 쇠고기는 판매량이 급증한것으로 나타났다	positive
가량 매출이 되레 줄었다	negative
가량 상승했다	positive
전년대비 증가하는 등 수입산 축산물의 성장세가 두드러졌다	positive
할인 행사 추진으로 가격 할인이 미미했던 반면 	negative
국내에서 활발한 마케팅을	neutral
진행했다	neutral
그 결과 올해	neutral
판매량도 크게 상승한 것으로 풀이되고 	positive
20번쨰 기사입니다	neutral
올해 돼지고기 수입량이 급증하면서 수입육 재고 적체도 심화되고 있어 돼지고기 시장에 부담요인이 되고 	negative
늘었다	neutral
이상이 수입되는 등 올해 수입량이 급증한데 	neutral
늘었다	neutral
특히 삼겹살의 경우 올해 수입량은 감소했음에도 3월 2만600	negative
톤이 쌓여 17년 대비 16.6	neutral
심화될 수 있는 만큼 경계의 목소리가 나오고 	negative
가격에도 부담이 될 수 있어 수입육에 대한 우려의 목소리가 커지고 	negative
저작권자 	neutral
양돈타임스 무단전재 및 재배포 금지임정은다른기사 보기 21번쨰 기사입니다	neutral
돼지 값 전망이 하향 조정됐다	negative
하락할 것으로 내다봤다	neutral
가량 낮아진 수준이다	negative
평균 4천827원)하며 약세를 이어	negative
수입량도 3만6천톤으로 지난해보다 더 늘 것으로 내다봤다	neutral
하반기 출하증가세가 더 두드러질 것으로 예상됐다	positive
이에 따라 하반기 돼지 값도 △7~8월 4천700~5천원(전년비 9.6	neutral
지난해 대비 하락세가 지속될 전망이다	negative
마련해야 한다고 입을 모으고 	neutral
저작권자 	neutral
  지난해 생산비 증가에도 돼지 두당 순수익은 더 는 것으로 조사됐다	neutral
<아래 표 참조	neutral
증가했다	neutral
가량 늘었지만 	neutral
가량 증가한 가운데 전체 생산비 중 51.8	neutral
상승한 8만6천원	neutral
늘어 생산비 증가에 한몫 했다	neutral
규모별 수익 차이가 컸다	positive
배에 달했다	neutral
이는 수입보다 생산비 차이에서 비롯된	neutral
분석됐다	neutral
)에 달했다	neutral
저작권자 	neutral
양돈타임스 무단전재 및 재배포 금지임정은다른기사 보기 22번쨰 기사입니다	neutral
소비자 가격 하락에도 식당 삼겹살 가격은 오히려 오른 것으로 조사됐다	neutral
올랐다	neutral
가격 인상폭이 큰 품목 중 하나가 바로 삼겹살이었다	neutral
(100g당 2천원→1천817원) 각각 하락했다	negative
임대료 등 다른 비용의 인상분이 반영된 것으로 파악된다	neutral
쉽게 변동되기 어렵다는 점도 한몫했다	negative
모르는 상황에서 메뉴 가격을 쉽게 내리기 쉽지 않다는 점이다	negative
얼어붙어 있는 한돈 소비 시장을 더 힘들게 할 수 있다는 우려가 나오고 	negative
저작권자 	neutral
양돈타임스 무단전재 및 재배포 금지임정은다른기사 보기 23번쨰 기사입니다	neutral
시작되면서 돼지	neutral
상승세를 이어가고 	positive
제주 제외 5천19원)으로 5천원대로 올라섰다	neutral
안정적으로 머물면서 	positive
연속 징검다리 연휴로 소비가 기대되면서 가격이 오른 것으로 분석되고 	positive
비교하면 올해는 50여일 늦었다	negative
저작권자 	neutral
육박하며 올해 누계 기준 이미 20만톤을 넘어섰다	neutral
늘었다	neutral
증가하면서 역대 최고 기록을 기록했던 11년과 17년의 수입량을 뛰어넘고 	positive
대비 45% 증가했다	neutral
전 수준에 그쳤다	neutral
증가하며 대조를 보였다는 것	neutral
특히 이 중 올해 국내서 큰 인기를	positive
고 있는 ‘이베리코	neutral
국가별 수입량에서도 스페인산의 약진이 눈에 띈다	neutral
감소했다	negative
급증했다	neutral
저작권자 	neutral
양돈타임스 무단전재 및 재배포 금지임정은다른기사 보기 24번쨰 기사입니다	neutral
배합사료업체들의 사료 값 인상이 ‘초읽기	neutral
국내 배합사료 가격도 인상 요인이 발생하고 	neutral
경영에 큰 타격을 입고 	negative
이에 최근 국내 배합사료업체들은 지방선거 이후 인상을 단행할 것으로 알려지고 	neutral
빠르면 이번주부터 현장에 인상을 통보	neutral
인상을 택했다	negative
25번쨰 기사입니다	neutral
가격이 6월에 이어 7월에도 5천원 안팎을 형성할 것으로 예측됐다	neutral
가격 전망 발표를 통해 7월 한돈 가격은 전년보	neutral
약세를 보여 4천900원	negative
하락한 가격이다	neutral
많은 124만마리가 출하될 것으로 전망되기 때문이다	neutral
산의 수입 단가 하락으로 전년 동월보다 증가한 3만톤이 들어올 것으로 예상됐다	negative
이후 연말까지 지속 하락 9	neutral
26번쨰 기사입니다	neutral
돼지 값이 올 들어 처음으로 5천원을 넘었다	neutral
오르면서 	positive
이는 그동안 부진했던 삼겹살 등 구이용 부위들의 판매가 살아나는 등 소비가 받쳐 준데다 출하물량도 올해 흐름에 비춰볼 때 상대적으로 많지 않았던 탓도 있다	positive
감소했으며 일년전	neutral
대비 돼지 출하 감소폭이 더 컸던 것으로 보인다	neutral
증가했던 4~5월에 이어 3개월만에 증가세도 꺾였다	negative
늘었다	neutral
지난해와 비교하면 6월도 하락세를 피하지 못했다	negative
낮았다	neutral
가량 낮았다	neutral
저작권자 	neutral
이하 하락 가능성이 우려되는 가운데 올해 연평균 돼지 값은 4천원 초반대를 기록할 것으로 분석됐다	negative
양돈관측을 통해 연평균 돼지 값이 4천100	neutral
낮고 	neutral
이처럼 올해 돼지 값이 하락하는 주된 이유는 출하물량 증가	negative
이상 하락세를 지속할 것으로 예상했다	negative
낮을 것으로 추산됐다	neutral
낮은 4천200~4천500원에 그칠 전망이다	neutral
낮을 것으로 예상됐다	neutral
저작권자 	neutral
양돈타임스 무단전재 및 재배포 금지임정	neutral
기사 보기 27번쨰 기사입니다	neutral
외식’은 줄고 	neutral
가정 내 한돈 소비를 늘릴 방안이 업계에 요구되고 	neutral
정부는 근로기준법 개정에 따라 지난 7월1일부터 300인 이상 사업장 직장인들에 한해 ‘주당 노동시간 52시간	neutral
사업장에선 2021년 7월 1일부터 각각 시행될 계획이다	neutral
근무제가 정착되면 돈육 소비 트렌드 역시 변화될 것으로 전망되고 	neutral
이는 직장인들의 직장에서의 시간이 줄어듦에 따라 장기적으로 회식 소비는 감소	neutral
대형마트에서의 한돈 입지를 확대해야 한다는 여론이 일고 	neutral
2017년도 한돈자조금 홍보 효과 분석 보고서에 따르면 돼지고기 구입 장소 여부에 대해 47	neutral
수입돈육과 한돈과 각축을 벌이고 	neutral
또한 간편식 시장도	neutral
지속적으로 확대될 것으로	neutral
한돈 식품업계도 분주하게 움직이고 	neutral
안주 간편식 매출 역시 상승세를 보이고 	positive
다양한 가정 간편식을 내놓는 등 가정 내 소비 증가 확대에 대한 준비를	neutral
나타나는 등 한돈 소비 확대를 위해 박차를 가하고 	neutral
28번쨰 기사입니다	neutral
자조금이 하반기 돈가 안정을 위해 한돈 수급 안정 예비비를 투입	neutral
안)에 대해 협의했다	neutral
이날 관리위원들은 올 하반기 등급 판정 마릿수 증가로 돈가가 크게 하락할 것으로 우려하면서	negative
추가 거출해 적립하고 있는 한돈 수급안정예비비	neutral
안)을 의결키로 했다	neutral
공급량을 축소하기 위해 조만간 수입육 업체를 대상으로 무분별한 수입 자제를 요청키로 했으며	positive
무더위와의 전쟁이 시작됐다	neutral
올해 장마가 끝났다는 분석이다	neutral
전국 대부분 지역에 폭염 특보 및 주의보가 내려졌다	negative
올 여름 찜통더위의 시작을 알린 셈이다	neutral
전국이 북태평양 고기압의 영향으로 덥고 습한 공기가 유입	neutral
면서 평년보다 높은 기온을 보이겠다고 	neutral
양돈농가들도 긴장하고 	negative
생산성 저하를 가져오는 것은 물론 내년 성적에까지 영향을 줄 수 있기 때문이다	negative
돼지들이 덥지 않도록 관리해야 한다고 	neutral
폭염 피해를 최소화해야 할 것이라고 당부하고 	neutral
저작권자 	neutral
양돈타임스 무단전재 및 재배포 금지임정은다른기사 보기 29번쨰 기사입니다	neutral
유지하면서 전년비 증가세를 지속했다	neutral
<표 참조	neutral
늘었다	neutral
전년 동기 106만2천마리에 견줘 0.7	neutral
월령별로 보면 4	neutral
가량 적은 113만9천마리로 조사됐다	neutral
농장의 규모화가 지속되고 있다는 흐름은 농장수 통계에서도 확인된다	neutral
즉 6월 기준 사육농장수는 6천195개로 3월	neutral
각각 감소했다	neutral
준 반면 5천마리 이상 사육 농장은 385호로 일년전 대비 1.6	neutral
각각 증가했다	neutral
저작권자 	neutral
양돈타임스 무단전재 및 재배포 금지임정은다른기사 보기 30번쨰 기사입니다	neutral
NULL31번쨰 기사입니다	neutral
기록적 폭염이 양돈시장의 주요 변수로 대두되고 	neutral
하락할 것으로 내다봤다	neutral
폭염으로 비육돈 폐사가 이어질 경우 5천	negative
이는 폭염 피해가 돼지 값도 좌지우지할 정도로 극심한 때문	negative
돼지 폐사는 8천410마리로 전년 동기간 5천330마리에 비해 57.8	negative
일평균 약 700여마리가 폐사한 것으로 나타났다	negative
가량이 폭염으로 폐사한 셈이다	negative
표본농가 조사 결과 최근 폭염으로 인해 출하일령은 182	neutral
늘었고 	positive
감소	positive
이 경우 돼지 값도 예상보다 오를 수 있다는 것이다	neutral
특히 올해 폭염의 영향이 내년까지 갈 수 있다는 지적이다	negative
산자수 저하 등 모돈 생산성 저하가 발생할 경우 내년 등급판정두수에 영향을 미칠 가능성이 있다고 	negative
저작권자 	neutral
양돈타임스 무단전재 및 재배포 금지임정은다른기사 보기 32번쨰 기사입니다	neutral
최근 도매시장에 저품질 돼지 출하가 급증하고 	negative
비율보다 증가한 것으로 나타났다	neutral
P 늘어났다	neutral
P 높게 나타났다	neutral
성장이 더딘 저체중 돼지 출하 비율이 크게 증가한 때문으로 분석되고 	negative
아프리카 돼지열병이 발생했다	negative
협회에 따르면 중국인민공화국농업농촌부 홈페이지의 내용을 번역	neutral
허난성 정저우 경제 개발구의 식품 회사 도축장에서 아프리카돼지열병이 발생했다고	negative
밝혔다	neutral
허난성 정저우 경제 개발구의 식품 회사 도축장에 있는 돼지들이 폐사하였으며	negative
검역증명서에 따르면 폐사돈은 흑룡강성 자무시시 탕원 소재 양돈장에서?	negative
출하된 것으로 확인됐다	neutral
이를 아프리카돼지열병으로 확진하였다	negative
33번쨰 기사입니다	neutral
수입산 모두증가했다	neutral
가량 줄었다	neutral
가량 감소한 때문이다	neutral
비교하면 올해 한돈 재고가 30	neutral
극명한 대조를 보였다	neutral
대부분의 부위들이 일제히 증가하면서 한돈 소비 부진을 입증했다	negative
검역시행창고 조사 결과 수입 돼지 정육 재고량은 9만1천톤으로 5월에 비해서도 6.7	neutral
공급 증가분에 비해 재고가 더 빠르게 증가한 셈이다	positive
늘었다	neutral
저작권자 	neutral
임스 무단전재 및 재배포 금지임정은다른기사 보기 34번쨰 기사입니다	neutral
국경검역 추진상황을 점검하고 	neutral
국가 검역에 비상이 걸렸다	negative
아프리카돼지열병 바이러스 유전자가 검출되었다고 	negative
검역당국에 자진 신고한 것이다	neutral
일반 여행객의 주의를 촉구했다	negative
한편 농림축산검역본부는 이번 축산물에 대해 실시한 1차 PCR	neutral
35번쨰 기사입니다	neutral
이날 행사에는 대한	neutral
자조금관리위원회 정상은 사무국장 등이 참여했다	neutral
민관이 힘을 합쳐 대국민 홍보 활동을 전개했다	neutral
국경검역 홍보 캠페인을 실시했다	neutral
가공품 반입 금지 등을 당부하는 홍보물을 제작하여 배포했다	negative
바이러스 유전자 검출로 반입이 금지된 축산물을 휴대해 올 경우 아프리카돼지열병의 유입 우려가 있다	negative
국민 모두의 관심을 당부한다	negative
밖에 답이 없다는 분석이다	negative
회의를 개최하고 하반	neutral
가격 안정 대책 등에 대해 논의했다	neutral
노산 모돈 도태 지원 등이 거론됐다	positive
현실성이 떨어진다고 	negative
확대는 어려울 것이라고 내다보며 장기적으로 추진키로 했다	negative
매진해야 된다고 	neutral
이를 위해 한돈자조금관리위원회는 이날 ‘18년 하반기 및 19년 상반기 한돈 소비 활성화 대책	neutral
컨셉을 통해 대대적으로 한돈 마케팅을 진행하겠다는 것	neutral
내년 황금돼지해에 맞춰 한돈 소비 붐을 형성하겠다고 	neutral
가격 안정화가 이뤄져야 자급률 제고 및 한돈 선호도를 보다 높일 수 있을 것이	neutral
고 의견을 모았다	neutral
36번쨰 기사입니다	neutral
돼지고기 수입량이 올 들어 	neutral
줄면서 	neutral
한달 수입량이 3만톤을 넘지 않은 것은 금년 들어 	neutral
최근 수입육 재고가 급증하면서 재고부담이 커진 것도 한 원인으로 풀이된다	negative
그럼에도 8월 수입량은 지난해 동월 2만7천톤에 비해서는 10.6	neutral
이로써 8월말 수입량은 32만9천톤을 기록	neutral
올해 수입량은 40만톤을 넘기면서 사상 최고치를 기록하게 된다	positive
준 12만7천톤에 그쳤다	neutral
수입량 14만7천500톤을 넘겼다	neutral
앞다리만이 아니다	neutral
6천400톤)을 크게 웃돌고 	neutral
부위들의 수입량은 모두 늘었다	neutral
국가별로는 미국이 13만3천톤(전년비 37.5	neutral
↑	neutral
저작권자 	neutral
양돈타임스 무단전재 및 재배포 금지임정은다른기사 보기 37번쨰 기사입니다	neutral
오른쪽)이 면담 후 사진촬영을 진행하고 	neutral
산업과 관련한 현안을 논의했다	neutral
철저한 국경검역을 요청했다	neutral
공항만 탐지인력과 탐지견 확충 등을 건의했다	negative
잔반급여를 일시중단 등 긴급조치가 필요하다고 	neutral
협조를 당부했다	neutral
연장시켜야 한다고 	neutral
가축분뇨 방류 처리 비중 설정해야 한다고 건의했다	neutral
또 한돈협회의 미래 핵심 사업인	neutral
정부의 아낌없는 지원을 요청했다	positive
이라고 지적했다	negative
항공기 내 남은 음식물 관리 등 국경검역을 철저히 이행하도록 노력하고 	positive
당부했다	neutral
한돈협회장 농축산부장관 간담회 결과(요약	neutral
비중이 늘고 	neutral
대응이 요구되고 	positive
자리를 지켰다	positive
소폭 감소한 실적이다	negative
지난해 돼지 값이 강세를 형성했음에도 포장육 생산이 준 것이다	positive
육류 제품들은 일제히 생산액이 크게 늘었다	neutral
늘었으며 식육가공품 중 햄 소시지 베이컨류의 생산액도	neutral
1조7천784억원으로 전년 대비 14.7	neutral
눈에 띄는 것은 가정 간편식 중 즉석섭취	neutral
급증하며 가장 두드러진 성장세를 보였다	positive
이처럼 식육 가공품과 간편식이 성장하고 	neutral
(전년비 0.7	neutral
신선육 상태보다 손쉽게 섭취할 수 있는 제품으로 소비가 이동하고 	positive
특히 간편식은 앞으로가 더 주목되고 	neutral
국내 식품업계의 대장주가 될 전망되고 	positive
노력이 요구되고 	neutral
저작권자 	neutral
양돈타임스 무단전재 및 재배포 금지임정은다른기사 보기 38번쨰 기사입니다	neutral
가능성이 가장 높다는 주장이 제기됐다	negative
정현규 도드람양돈농협동물병원장은 지난 17일 	neutral
히 대비해야 한다고 	neutral
확산되면 바이러스가 국내로 유입될 경우 다양한 경로로 국내 양돈장에 침투할 가능성이 높고 	neutral
재입식이 불가하다	negative
국내 농장에 발생하는 확률이 가장 높다	negative
이라고 당부했다	neutral
올해도 가을 양돈불황의 우려는 접어도 될 듯싶다	negative
의견이 모아졌다	neutral
〈관련기사 http	neutral
대부분 연초 우려했던 불황 가능성은 낮게 봤다	negative
여기에는 예상 밖으로 호조를 보이고 	positive
이상 형성하며 강세를 보이고 	negative
이는 국내 돼지고기 소비 기반이 그만큼 탄탄하다는 반증으로 해석할 수 있다는 의견도 있었다	positive
이와 함께 돼지 값 하락을 불러올 최대 변수로 지목됐던 출하가 예상보다 크게 늘지 않을 수 있다는 분석도 이 같은 전망을 뒷받침했다	negative
많은 자돈이 폐사하면서 	negative
이는 사료량으로도 뒷받침됐다	neutral
향후 출하를 예측할 수 있는 포유돈 사료량과 임신돈 사료량이 전년 대비 크게 늘지 않거나 오히려 줄었다는 것이다	neutral
분기 변수가 될 수 있다는 분석이다	neutral
분기에 작업물량을 늘릴 수 있다는 것이다	neutral
한돈 재고를 확보하기 위해서다	neutral
돼지 값은 올해도 불황과는 거리가 멀 것이란 전망이 다수를 차지한 것이다	negative
급락 가능성도 동시에 경고됐다	negative
연속 징검다리 휴일이 들어 	neutral
자연히 이 기간 하루 출하물량이 급증하면서 하락폭을 키울 수 있다고 	negative
변동성도 확대된 만큼 긴장의 끈을 놓지 말아야 한다는 지적이다	negative
관리도 중요한 시점이라고 당부했다	neutral
저작권자 	neutral
양돈타임스 무단전재 및 재배포 금지임정은	neutral
김현구 기자다른기사 보기 39번쨰 기사입니다	neutral
가운데 이처럼 지역화를 인정해 달라는 축산물 수출국들의 요구가 더 거세질 수 있다는 경고가 나왔다	negative
이 같은 결론을 냈다	neutral
축산물 수입 규제와 관련된 것들이었다	neutral
수입을 허용하는 방향으로 결론이 났고 	neutral
미국의 가금 및 가금육도 지역화를 인정받은 사례다	neutral
농경연은 선진국들과 농산물 수출국들이 최근 지역화를 적용하려는 추세라고 지적하며 우리가 현재 진행 중인 무역 협상들에서 지역화 인정 및 수입금지 해제 요구가 증가할	neutral
이라고 지적했다	negative
더 많은 지역화 인정 혹은 수입 해제 결과를 가져올 수 있다는 것이다	neutral
이에 농경연은 관련 검역분야 인력과 조직을 보강하고 제도를 정비하는 것이 시급하다고 	negative
저작권자 	neutral
  정부가 내년 2월까지 구제역 특별 방역 대책을 추진키로 했다	neutral
강도 높은 가축질병 예방활동과 유사시 대응체계 구축 등 총력 방역활동을 전개한다고 	neutral
홍보를 강화키로 했다	neutral
면역 수준을 확인하기 위해 11	neutral
만두로 확대 비축하여 발생에 대비한다	neutral
점검과 소독을 강화하고 대상자별 눈높이에 맞는 맞춤형 교육을 확대하는 한편 생산자단체	positive
개선해 대응한다는 계획이다	neutral
가격 예상 밖 상승에는 폭염 여파가 가장 큰 영향이라는 분석이다	neutral
안팎의 상승을 기록했다	positive
올해 월평균 돼지 값이 지난해보다 높았던 것은 9월이 처음이다	neutral
출하가 이를 해소시켜줄 정도로 충분치 못했던 영향이다	negative
증체 지연이 지속되면서 	negative
8일로 전년 동월 182	neutral
감소했다	negative
이에 따라 추석 2~3주 전 일평균 등급 판정 마릿수는 7만2천마리로 전년 동기간 7만4천마리보다	neutral
도매시장 경락 마릿 수 역시 3천284두로 전년 동기간 3천858두보다	neutral
감소해 한돈 가격도 상승한 것으로 분석되고 	neutral
발생하면서 수입물량 감소를 대비한 유통업계의 물량 확보 수요도 있었다는 지적이다	negative
저작권자 	neutral
양돈타임스 무단전재 및 재배포 금지임정은다른기사 보기 40번쨰 기사입니다	neutral
오프라인에서 대대적인 마케팅을 진행한다	neutral
한돈 판촉에 나섰다	positive
저렴한 가격에 제공하기 위해 마련했다	positive
이를 위해 10월 4일부터 19일까지는 요일별로 특정 부위를 선착순 50	positive
금요일 삼겹부위이다	neutral
할인 판매한다	positive
행사가 대대적으로 개최된다	positive
품질 좋은 우리 돼지 한돈의 다양한 부위를 제공할 계획이다	positive
따뜻한 마음을 지역사회에 전할 계획이다	positive
돼지고기 시장에서 원료육	neutral
햄 소시지 등 가공품)의 비중이 날로 커지고 	neutral
늘었다	neutral
식육 가공품 생산량이 이 기간 13만7천톤에서 21만1천톤으로 55	neutral
늘었다	neutral
전체 한돈 시장에서 원료육의 비중이 그만큼 증가한 것이다	neutral
원료육이 한돈 전체 수급에 미치는 영향력이 커지고 	neutral
문제는 수입육이 원료육 시장을 노리고 	negative
수준을 유지하는 가운데 그 차이가 더 벌어지고 	neutral
최근 품질에서 조차 한돈과 수입육의 격차가 좁혀지고 있다는 지적이다	negative
여지를 넓히고 	negative
원료육 시장을 사수하려는 노력이 요구되고 	neutral
저작권자 	neutral
양돈타임스 무단전재 및 재배포 금지임정은다른기사 보기 41번쨰 기사입니다	neutral
제주도에서 유행성설사병	neutral
지역 농가들이 반발하고 	negative
2018년도 축산악취 현황조사	neutral
2018년 축산악취 현황조사는 제주시 15개 마을	neutral
발생 주의보를 발령했다	negative
발생하고 있는 지역은 한림읍과 대정읍으로 이 지역에 축산 악취 현황 조사가 예고 된 지역이다	negative
확산도 우려되고 	negative
전파 우려 되는 일을 벌이고 	negative
42번쨰 기사입니다	neutral
국내 가구의 식비 중 가공식품 지출이 가장 빠르게 늘고 	neutral
최근 농림축산식품부와 농촌경제연구원은 지난해 기준 우리나라 가구의 가공식품 지출구조를 분석한 결과 식료품비 가운데 가공식품 지출 증가율이 가장 높았다고 	neutral
가장 빠르게 늘었다	neutral
비교해도 최근 증가율이 더 가팔라	neutral
다	neutral
식생활에서 편의성이 중시되고 	neutral
최근 지출이 빠르게 늘고 	neutral
한편 지난해 가구당 월평균 식료품 지출액 71만6천원 가운데 외식이 34만1천원	neutral
저작권자 	neutral
양돈타임스 무단전재 및 재배포 금지임정은다른기사 보기 43번쨰 기사입니다	neutral
곡물확보 방안이 필요하다는 주장이다	neutral
급등주기가 이후에는 1~3년으로 짧아졌다고 지적했다	negative
곡물 가격 급등 주기 사이에 연관관계가 발생하고 	negative
콩 가격이 급등했다	negative
대비가 필요하다는 지적이다	neutral
콩 작황이 양호해 곡물 가격의 급등 가능성이 낮지만 	neutral
곡물 도입시점을 조정할 필요가 있다고 	neutral
수입방식 다변화 등 중장기적으로도 대책이 마련돼야 한다고 	neutral
저작권자 	neutral
양돈타임스 무단전재 및 재배포 금지임정은다른기사 보기 44번쨰 기사입니다	neutral
추석 한돈 추석 선물세트 판매량이 역대 최고를 달성한 것으로 추정됐다	positive
신장했다고 	positive
상승했다고 	positive
경품 이벤트 등 다양한 혜택 제공 때문으로 풀이된다	positive
오프라인 한돈 선물세트 판매도 두드러졌다	neutral
신장하였다	positive
품질 측면에서 소비자의 만족도를 충족시키며	positive
45번쨰 기사입니다	neutral
타이틀을 올해도 지킬 수 있을까	neutral
쌀값은 전년 대비 크게 오르면서 	negative
돼지 생산액은 지난 16년 6조8천억원을 기록하며	neutral
미곡(6조4천억원)을 누르고 	positive
생산액이 많았다	neutral
생산액 순위는 변동이 없을 것으로 추산됐다	neutral
쌀값이 예상보다 크게 올랐다	negative
가량 높아 예상보다 상승폭이 컸다	neutral
↓)은 떨어졌다	negative
자리바꿈할지 주목되고 	neutral
저작권자 	neutral
돼지의 목심 부위 이외 뒷다리에도 이상육 발생 비율이 증가하는 것으로 나타났다	neutral
이상육 발생이 나타난 것으로 집계됐다	negative
발생	neutral
증가하며 매년 이상육 발생이 증가하고 	neutral
눈여겨 볼 점은 뒷다리 발생 비율로 2016년 발생 비율이 1.8	neutral
이는 지난해부터 농가들이 목심 부위 이상육 발생으로 인한 페널티 부과로	negative
일부 농가들이 뒷다리에도 접종	neutral
예상된 가운데 뒷다리 부위에도 구제역 접종이 가능하도록 변경됐다	neutral
향후 목심 이외 뒷다리 부위에도 이상육 발생이 증가할 것으로	neutral
우려되고 	negative
이상육 발생은?	neutral
최근 뒷다리에서도 이상육 발생 비율이 높아지는 것을 봤을 때 구제역	neutral
백신 접종이 이상육 발생의?	neutral
원인으로 추정할 수	neutral
46번쨰 기사입니다	neutral
악성 질병이 고개를 들고 	negative
농림축산검역본부에 따르면 지난 10월부터 제주도와 충남지역을 중심으로 PED 발생 건수가 증가	neutral
증가했다	neutral
기록을 넘어설 것으로 예측되고 	neutral
유행성 설사 발생 주의보를 발령했다	negative
최근 구제역 발생도 우려되고 	negative
방역 당국이 긴급 방역에 나선 것이다	neutral
검출된 충남 홍	neutral
구제역 유전자가 검출됐다고 	neutral
홍성군 전체 돼지농가에 대한 구제역 항체	neutral
발생 주의보 발령 등 올 겨울철 각종 질병 발생이 우려되고 	negative
농가들의 방역 강화가 요구되고 	neutral
47번쨰 기사입니다	neutral
돼지 부산물 시세도 찬바람에 불고 	negative
하락했다	negative
지난해 동월 대비로는 모든 부산물이 일제히 하락했다	negative
떨어져 가장 하락폭이 컸다	negative
돼지 부산물 수입도 증가한 때문이다	negative
특히 돼지 부산물 수입량은 지난 9월말까지 14만3천여톤이 들어와 일년전 123만톤에 비해 16	neutral
순으로 많이 들어왔다	neutral
돼지 부산물 수입량이 가장 많았던 11년 같은 기간 14만2천톤에 견줘서도	neutral
해가 더 많다	neutral
수입 부산물 재고도 늘어 9월말 기준 돼지 부산물 수입량은 2만7천여톤으로 일년전에 비해 42.3	neutral
저작권자 	neutral
양돈타임스 무단전재 및 재배포 금지임정은다른기사 보기 48번쨰 기사입니다	neutral
값이 10월보다 낮았다	neutral
각각 떨어졌다	neutral
시작하던 지금까지의 돼지 값 흐름을 감안하면 올해는 다소 예외적인 상황인 셈이다	neutral
돼지 값이 10월보다 낮았던 경우는 지난 97년 이후 21년만이다	negative
공교롭게도 97년은 돼지고기 수입이 자유화된 해이기도 하다	neutral
돼지 값이 이처럼 하락한 것은 무엇보다 출하가 많았던 것이 한 원인이다	negative
10월 168만6천마리에 비해서는 다소 줄었다	neutral
시장에 부담이 된 것으로 보인다	negative
소비도 저조했다	negative
올해는 이렇다 할 김장철 특수를 감지하기 어렵다	negative
한돈 시장에도 적지 않은 부담이 될 것으로 전망되고 	negative
저작권자 	neutral
양돈타임스 무단전재 및 재배포 금지임정은다른기사 보기 49번쨰 기사입니다	neutral
11월 돼지고기 수입량이 4만톤이상	neutral
기록하면서 올해 수입량이 40만톤을 넘어섰다	neutral
각각 늘었다	neutral
4월(4만7천톤)에 이어 네 번째로 많고 	neutral
요인에 따른 것으로 보인다	neutral
수입량이 40만톤을 넘기면서 사상 최고치 기록을 경신했다	positive
이상이 될 가능성이 높다	neutral
11월 수입량을 부위별로 보면 역시나 연말 수요가 많은 삼겹살이 10월에 비해 무려 66	neutral
그럼에도 11월말로 보면 앞다리가 18만1천톤으로 일년전보다 34.7	neutral
이상 늘었다	neutral
최근 국내 등심 수요가 증가하면서 한돈 등심이 고가를 형성하고 	neutral
칠레	neutral
2천톤 순을 기록했다	neutral
저작권자 	neutral
양돈타임스 무단전재 및 재배포 금지임정은다른기사 보기 50번쨰 기사입니다	neutral
수매 비축’ 카드를 꺼내 들었다	neutral
농가 피해가 심화됨에 따라 최근 긴급 회의를 개최	positive
비용을 지원하는 것이다	positive
비용을 지원한다	positive
자조금관리위원회는 수급위의 결정 사항을 토대로 도매시장 후지 수매 비축 사업을 위한 계획을 수립하고 	neutral
농림축산식품부의 최종 승인이 남아 있다	neutral
51번쨰 기사입니다	neutral
NULL52번쨰 기사입니다	neutral
중단할 것을 촉구했다	negative
협회는 최근 극심한 경기불황과 급격한 돈가 폭락으로 농가경영에 위기감이 고조되고 	negative
이에 협회는	neutral
12월 28일 성	neutral
확장이 진행될 경우 이는 양돈농가들의 생존권을 심각하게 위협하는 하는 행위	negative
협회는	neutral
농가의 바램을 짓밟는 행위이며	negative
이에 협회는 기업자본의 무분별한 농장 매입시도가 계속될 경우 해당 업체의 실명과 농장매입 내용을 공개하겠다고 강조했다	neutral
53번쨰 기사입니다	neutral
년 돼지고기 수입량이 40만톤을 처음으로 넘기며 사상 최고치를 기록했다	positive
늘었다	neutral
이로써 18년 수입량은 46만3천500으로 17년 37만톤보다 25.5	neutral
한돈 생산량 증가에도 수입량이 증가한 이유는 수요와 공급 측면 모두에서 찾을 수 있다	neutral
중국이 수입을 줄이면서 	neutral
가공용 부위 수입이 유독 크게 늘었다	neutral
앞다리가 19만7천톤으로 일년전보다 34	neutral
밀렸다	neutral
↑)이 급증했다	neutral
시작한 이베리코 등 수입육의 인기도 한몫했다	positive
그 인기를 실감케 했다	positive
대가 무너졌다	negative
불과했다	neutral
이후 최저 수준을 기록한 것이다	negative
저작권자 	neutral
  돼지 열병 바이러스가 휴전선 부근에서 내륙으로 남하하고 	negative
강원도 영월군에서 포획한 야생멧돼지의 혈액을 분석한 결과 돼지열병 항원 양성으로 판정됐다	neutral
강원 인제 야생멧돼지에서 검출된 바이러스와 유사한 것으로 확인됐다	neutral
돼지열병 바이러스가 휴전선 인근 지역에서 야생멧돼지를 통해 점차 남하하고 	negative
이에 박멸위	negative
미끼 예방약 적용 등 대책이 필요하다고 	neutral
이상 급성장하고 	positive
늘었다	neutral
늘어 더 빠른 성장세를 보였다	positive
소비는 계절적 흐름이 뚜렷했다	neutral
일반햄과 소시지류는 야외활동이 활발한 3분기에 가장 많이 판매되는 것으로 조사됐다	neutral
소비량도 빠르게 늘었다	positive
신장률을 기록했다	positive
많았고 남성 가운데서도 6~11세가 4천880g을 섭취	neutral
저작권자 	neutral
양돈타임스 무단전재 및 재배포 금지임정은다른기사 보기 54번쨰 기사입니다	neutral
분기 출하두수 부족 현상은 약화될 전망이다	negative
복당 총 산자수는 10.83두	neutral
번식성적이 전년과 비교해 상승한 것으로 나타났다	neutral
분기 출하두수를 예측할 수 있는 중요한 시기다	neutral
분기 출하두수 부족 현상은 약화될 전망이다	negative
모돈 관리를 철저하게 한 것으로 추정된다	negative
연중 생산성이 가장 높았다	neutral
55번쨰 기사입니다	neutral
감소했지만 전년 대비로는 소폭 증가했다	neutral
통계청에 따르면 18년 12월 기준 돼지 사육두수는 1천133만3천마리로 9월 1천164만1천마리보다	neutral
(30만8천마리) 줄었다	neutral
소폭 증가했다	neutral
전에 견줘서는 0.5	neutral
월령별로 보면 전분기에 비해서 	neutral
가량 줄었다	neutral
감소했다	negative
전체 농장수는 6천188개로 집계돼 전분기보다 8개	neutral
) 적었다	neutral
줄고 17년 동기간에 비해서는 2.6	neutral
저작권자 	neutral
양돈타임스 무단전재 및 재배포 금지임정은다른기사 보기 56번쨰 기사입니다	neutral
경기도 안성지역에 구제역이 추가 발생하면서 확산이 우려되고 	negative
농림축산식품부는 지난 29일 경기도 안성시 소재 한우 농가(사육규모 97두)에서 구제역 의심축이 추가로	neutral
경기도 동물위생시험소의 정밀검사 결과 구제역 바이러스가 확진됐다고 	negative
농림축산검역본부에서 검사 중이라고 밝혔다	neutral
최초 발생 농장과 11km 떨어진 농장이다	neutral
다리절음 등의 구제역 임상증상을 보여 안성시청에 신고하였다	neutral
조치를 신속히 취하였으며	neutral
돼지 출하물량 증가와 소비 부진이 겹치면서 	negative
추정한 11월말 기준 한돈 재고량은 5만7천톤으로 전달 4만6천톤	neutral
줄고 일년전에 비해서 3.6	neutral
한돈 재고가 5만톤대를 기록한 것은 이번이 처음이다	neutral
이처럼 불어	neutral
분기 이후 돼지 값이 3천원대를 벗어나지 못하고 있는 가장 큰 걸림돌이 되고 	negative
감소했음에도 모든 부위가 증가했다고 지적했다	negative
증가세를 기록했다	neutral
소비가 안됐다는 얘기다	negative
한돈 소비도 중요한 원인이라고 지적하며 업계가 한돈 소비 진작방안을 적극 강구해야 할 때라고 강조하고 	negative
저작권자 	neutral
  젖소 농장에서 구제역이 확진돼 방역당국이 긴급 방역 조치에 나섰다	negative
구제역 바이러스가 확인되었으며	neutral
구제역 바이러스로 확진되었다고 	negative
구제역 긴급행동지침(SOP)에 따라 ’주의	neutral
가축방역심의회를 개최하여 선제적인 방역대책을 추진키로 했다	neutral
차량과 사람의 이동이 예상되어 구제역 전파 우려가 있는 점 등을 고려하여 강력한 방역조치를 실행	negative
조치라고 농축산부는 설명했다	neutral
동안 일시이동중지명령 발령했다	neutral
신속한 살처분 실시했으며	neutral
소유 차량은 운행을 중지한 후 차량 세척 및 소독을 실시하며	neutral
철저한 소독을 실시할 것을 당부했다	neutral
저출산 고령화가 향후 국내 소비시장을 재편하는 주된 동력으로 꼽혔다	neutral
가치소비 세대가 지목됐다	neutral
국내 소비시장이 빠른 속도로 재편되고 	neutral
확대가 첫 번째로 꼽힌 변화다	neutral
온라인 쇼핑에도 능하다고 	positive
나홀로’로 바뀌고 	neutral
불과했던 1인 가구 비중은 17년 28.6	neutral
선호도가 높아졌다	neutral
이와 함께 가치소비가 확산되고 	positive
대한상의는 내다봤다	neutral
저작권자 	neutral
양돈타임스 무단전재 및 재배포 금지임정은다른기사 보기 57번쨰 기사입니다	neutral
NULL58번쨰 기사입니다	neutral
돼지 출하물량이 처음으로 170만마리를 넘기면서 사상 최고치를 기록했다	positive
문턱도 넘지 못했다	neutral
축산물품질평가원에 따르면 1월 돼지 출하는 173만2천마리로 전달 152만6천마리보다	neutral
각각 증가했다	neutral
기록을 경신한 것이다	positive
돼지 출하가 급증한 때문이다	neutral
일별 출하두수 추이를 보면 하루 평균 7만5천	neutral
이후(5년3개월) 가장 낮은 수준을 기록했다	negative
저작권자 	neutral
대책이 시급한 것으로 나타났다	negative
소시지 등 ASF전파 위험 축산물의 불합격 실적은 14년 2만3천377건	negative
휴대 반입된 ASF전파 위험 축산물의 불합격 실적 가운데 80	negative
휴대 돈육이 지난해 국내에 불법 반입되다가 걸렸다는 점이다	negative
과태료 인상의 당위성을 설명하고	negative
59번쨰 기사입니다	neutral
김용철 육류유통수출협회장이 재선출됐다	neutral
안)을 의결했다	neutral
이날 협회는 김용철 회장을 만장일치로 재선임하는 동시에 3년 임기의 제10대 협회 임원도 선출했다	neutral
식육가공업 회원사들에 감사를 표한다	positive
다	neutral
현재 불합리하게 결정되고 	neutral
아래와 같은 사업을 중점적으로 추진하기로 했다	neutral
협회와 공동으로 현재 답보상태에 있는 돼지도체 등급별 정산을 추진하여 올해 12월까지 정착시키기로 했다	positive
돼지가격 결정구조를 연구용역과 돼지 선물거래제도 도입 등을 통해 개선하기로 했다	negative
대응방안 마련을 위해 노력하기로 했다	positive
관련기관과의 대외협력 활동을 강화하기로 했다	neutral
통하여 협회 수지 안정을 도모키로 했다	positive
농가를 돕기 위해 한돈 소비 촉진 행사를 진행했다	positive
농협은 지난 14일 서울시청 인근에서 송태복 농림축산식품부 축산경영과장	neutral
아침 출근길 시민들에게 무료증정했다	positive
축산농가 소득증대를 위하여 양돈농협과 함께 연중 돼지고기 가격안정대책을 마련하여 추진키로 했다	positive
농가에게 큰 희망을 줄 수 있다	positive
수입업체들의 무분별한 수입을 중단해야 한다고 촉구했다	negative
빠르게 국내시장을 잠식하면서 국산 돼지고기 가격폭락의 주원인으로 분석되고 	negative
감소하는 등 자급율도 해마다 떨어지고 	negative
특히 올해는 돼지고기 수입량이 감소할 것이라는 예상과 달리 지난 1월 수입량도 4만7천593톤이 수입되어 	negative
돼지고기 수입업체들은 무분별하게 수입량을 증가시키고 있다고 지적했다	negative
도매시장 가격안정을 위한	positive
한돈 시장을 혼탁하게 만들고 	negative
무관세로 무장한 일방적 행위로 국내의 돼지고기 유통시장을 혼탁하게 하고 	negative
영위하는 축산관련 기업에서의 수입 중단을 촉구했다	negative
60번쨰 기사입니다	neutral
불을 지폈다	neutral
할인된 가격에 선착순 판매한다	positive
정육점 삼겹살 100g당 330원 할인 판매를 진행한다	positive
한돈 농가도 직접 홍보에 나선다	neutral
한돈 할인 판매 및 시식 행사를 전국적에서 열기로 한 것	neutral
전 국민과 함께 맛있는 한돈 삼겹살을 나눠먹을 예정이다	positive
전국 양돈농협도 도단위 시식회 및 나눔 행사를 3월 한달 내내 진행할 계획이다	positive
이같이 삼겹살 데이를 	neutral
단계로 하향 조정했다	neutral
만인 2월25일을 기하여 모두 해제하였다고 	neutral
우제류 가축을 검사한 결과 이상이 없는 것으로 확인되어 	neutral
상황실을 지속 운영하는 등 비상체계 속에서 취약분야 방역관리에 집중할 계획이라고 밝혔다	neutral
61번쨰 기사입니다	neutral
한돈 시장에는 봄바람도 비켜갈 듯 보인다	neutral
중반대를 넘기 어려울 것으로 전망돼서다	negative
하락할 것으로 예측했다	neutral
늘 것으로 추산한데 	neutral
돼지고기 생산량으로 따지면 8만톤 내외가 될 것이란 설명이다	neutral
농경연은 내다	neutral
다	neutral
지난해 3월 5만1천톤보다 소폭 증가한 5만2천톤 내외가 될 것으로 전망했다	neutral
이 경우 한달 수입량으로는 사상 최고치가 된다	neutral
EU 등 주요 수출국의 가격 하락 때문이다	neutral
각각 떨어졌다는 설명이다	neutral
이후에도 증가세를 이어	neutral
돼지 사육두수가 3월 1천130만	neutral
등급판정두수 역시 693만마리로 전년 동기보다 2	neutral
농경연은 이처럼 돼지 출하물량이 증가하면서 돼지 값이 전년 대비 약세를 나타낼 것이라고 전망했다	negative
저작권자 	neutral
  지난해 사상 최대의 돼지 사육 두수에도 양돈장 항생제 사용량이 줄었다	neutral
감소했다	negative
수산에서 항생제 판매량이 크게 감소했기 때문이다	negative
감소했다	negative
반면 소와 닭의 항생제 판매량은 늘었다	positive
페니실린계(259톤) 항생제가 가장 많이 판매된 것으로 조사됐다	neutral
이 같이 양돈장에서 항생제 사용량이 줄어든 배경에는 지	neutral
농가들도 무분별한 항생제 사용을 자제했기 때문으로 풀이된다	neutral
62번쨰 기사입니다	neutral
가격 하락에 한돈 품질도 향상되지 못했다	negative
각각 하락했다	neutral
전달 대비로도 내림세를 이어가면서 3천원대도 어렵게 지켜냈다	negative
이후 가장 낮은 수준이다	negative
하락 요인은	neutral
무엇보다 돼지 출하물량이 많았던 때문이다	neutral
일평균으로 따져보면 7만7천여마리로 7만5천여마리를 기록한 지난해 동월보다 3	neutral
등급 이상 출현률도 지난해보다 감소했다	negative
축산물품질평가원에 따르면 2월 돼지 등급판정 두수는 129만마리로 일년전 134만2천마리보다	neutral
감소했다	negative
이상을 기록했던 영향으로 2월말 누계 기준으로는 올해 300만8천마리를 기록	neutral
P 낮았다	neutral
전과 같은 64.2%를 기록했다	neutral
저작권자 	neutral
양돈타임스 무단전재 및 재배포 금지임정은다른기사 보기 63번쨰 기사입니다	neutral
감소 시 세계 돈육 공급량은 10년전 수	negative
회귀한다는 주장이 제기됐다	neutral
세계 육류 수급 현황 및 전망에 대해 발표했다	neutral
생산량이 감소되면서 세계 돈육 시장이 출렁거릴 것	negative
중국 돈육 부족 물량은 미국만이 대체할 수 있다고 	neutral
한국은 미국산 돼지고기의 최대 소비 시장 중의 하나로 매년 성장세가 주요 수입 국가 중에 가장 가파르다	positive
식자재 한돈 물량 사용 확대에도 노력해야 한다는 주장이다	neutral
신세계푸드 등 국내 식자재 업체들과 한돈 사용 확대 관련 간담회를 개최했다	neutral
가격 약세에 따라 한돈 사용량을 늘리고 	neutral
형성함에 따라 주요 식재료인 한돈 후지 가격도 폭등	negative
대체했다	neutral
수입 돈육 비율을 차츰 늘려갔다	neutral
그렇다면 식자재 업체가 한돈 물량을 늘릴 수 있는 방안은 무엇일까	neutral
이에 이들은 식자재 회사들이 업체마다 사용하는 부위나 계약 방식 등이 다르기 때문에 쿠폰	neutral
급식 메뉴의 경우 영양사들이 좌지우지 할 수 있기 때문에 영양사 지원 방안 및 한돈을 사용하는 메뉴 개발 검토도 효과적일 것이라고 조언했다	positive
돼지고기의 음식점 소비 감소세가 1분기 더 심화될 것으로 전망됐다	negative
감소한 것으로 분석됐다	negative
더 줄 것으로 예측된 것이다	neutral
외식 시장이 위축되고 	negative
계란 등에서도 공통적으로 나타나고 	neutral
수준이었으며 한돈에 이어 	neutral
저작권자 	neutral
양돈타임스 무단전재 및 재배포 금지임정은다른기사 보기 64번쨰 기사입니다	neutral
출하물량이 늘어 전년 대비 약세 흐름은 이어질 전망이다	negative
농촌경제연구원은 지난달 25	neutral
대비 상승세로 전환할 것으로 내다봤다	positive
가량 낮을 것으로 분석했다	neutral
가량 적은 4만톤이 전망됐다	neutral
들어 국제 가격 상승으로 전년 대비 감소세로 전환됐다는 지적이다	negative
이런 가운데 국내 돼지 사육두수는 당분간 증가세가 이어질 전망이다	neutral
↑)로 더 늘 것으로 내다봤다	neutral
반대로 수입량은 국제 돈가 상승으로 전년 대비 감소할 것으로 전망됐다	negative
한돈협회가 모돈 감축	neutral
사업계획 승인 등 상정된 안건들을 원안대로 승인했다	neutral
안)은 심도 있게 논의한 결과	neutral
이날 대의원들은 모돈	neutral
기업들이 모돈을 되레 늘릴 우려가 있어 	negative
수입돈육 업계의 수입량 축소와 대기업 모돈 감축이 선행돼야한다는 의견이 모아졌다	neutral
전체 한돈 농가의 모돈 감축을 시행키로 결의했다	neutral
모돈 감축 보다는 규모별 차등적용을 검토하여 진행키로 했다	neutral
돈가 안정화에 도움이 되는 방향을 추진하겠다	positive
한편 한돈협회는 이날	neutral
김해지부를 2018년도 최우수지부로 선정했다	positive
특별상에 대한 표창을 실시했다	positive
선정되는 영예를 안았다	positive
농림축산식품부 장관상을 수상했다	positive
한돈자조금이 식자재 업체 및 육가공업체를 대상으로 수입 돈육서 한돈 사용으로 전환 시 그	neutral
액을 지원키로 했다	neutral
안)에 대해 협의했다	neutral
하락할 것으로 우려하면서 	negative
이에 관리위는 수급안정예비비	neutral
육가공업계 한돈 뒷다리 사용 확대 지원에 자조금을 투입한다는 계획이다	positive
예산을 지원키로 했다	positive
수입 돈육 사용 대신 한돈 사용량을 증대한 업체에 차액을 지원하는데 	positive
한돈 급식 확대를 위해 영양사를 대상으로 소비 촉진 프로모션도 진행키로 했다	positive
수입돈육량 감소를 기대하며 장기적으로 돈가 낙폭 최소화에도 기여할 것으로 내다봤다	positive
65번쨰 기사입니다	neutral
관심’으로 하향 조정하는 등 평시 방역체계로 전환했다	neutral
고려해 위기경보 단계를 하향 조정했다	neutral
예년과 비	neutral
예방적 조치에 협조해 주신 국민 여러분들께도 감사드린다	positive
분기 출하두수는 지난해보다 다소 많았다	neutral
전년 대비 감소했다	negative
가량 감소했으며 3월 역시 지난해 동월 146만7천마리 대비 2	negative
예상된 가운데 이 같은 출하 감소세가 계속 이어질지 주목되고 	negative
가량 소폭 늘었다	neutral
돼지 값 하락폭은 컸다	negative
낮았던 것으로 집계됐다	negative
한편 3월말 돼지 값이 근 6개월만	negative
4천원을 넘었다	neutral
상승하며 안정세를 유지하고 	positive
세계 돼지 값이 상승세를 보이고 있는 것도 한 원인으로 파악되고 	positive
가량 감소했다	negative
이에 향후 세계 돼지고기 교역과 돈가 추이에 따라 국내 시장에 미칠 여파가 주목되고 	neutral
저작권자 	neutral
양돈타임스 무단전재 및 재배포 금지임정은다른기사 보기 66번쨰 기사입니다	neutral
돼지 값 상승세에 더 불을 지필 수 있을지 주목되고 	negative
지난 4일 돼지 지육 평균 경락가격	neutral
벽을 뚫은 것이다	neutral
연속 전년 대비 감소했다	negative
또 4월 들어서도 일평균 출하물량이 6만8천여두로 지난해 동월 평균	neutral
수준에 못 미치고 	negative
수입량도 마찬가지다	neutral
연속 전년 동월보다 감소하면서 	negative
향후 늘기 어려운 상황	negative
본격적으로 소비가 증가하기 시작하는 시기에 이처럼 공급량 감소세가 이어질 경우 돼지 값은 더 상승 탄력이 붙을 수 있어 약세로 시작한 올해 양돈시장의 반전이 이뤄질 가능성이 높아지고 	negative
저작권자 	neutral
가격과 상관없이 향후 수입 물량이 지속 증대되면서 한돈 시장을 잠식해 나갈 것이라는 주장이다	negative
경쟁육으로 급부상했다	neutral
이라고 우려했다	negative
발생해 소비자들의 불만이 높아지고 	negative
수입 돈육 급증에	neutral
제언했다	neutral
돼지 개량에도 심혈을 기울여야 할 때	neutral
67번쨰 기사입니다	neutral
향후 모돈 두수가 증가할 여지도 많아졌다	neutral
대상으로 종돈장 실태조사를 실시했다	neutral
F1생산용) 모돈의 사육규모는 8만480두로 전년	neutral
세부적으로 살펴보면 순종 생산용 모돈은 1만6천441두로 지난해보다 0.3	neutral
평균 640두를 사육하고 	neutral
혼용 농장들도 같은 이유로 사육 규모를 늘린 것으로 추정되고 	neutral
한돈 품질 개선에 청신호가 켜진 것일까	positive
3월 돼지 등급	neutral
정 성적이 향상되면서 	positive
대비 다소 감소했다	negative
기록하며 1등급 이상 출현율이 65	neutral
P 상승한 수치다	neutral
P 올랐다	neutral
등급판정 기준 변경 이후 가장 높았던 것으로 분석됐다	neutral
저작권자 	neutral
다비육종 제공올해도 ‘양돈 불패	positive
분기 이후 돼지 값 약세로 지난 13년 이후 처음으로 적자가 예상됐던 올해 양돈업이 최근 기적처럼 기사회생할 조짐을 보이고 	negative
전망은 어두웠다	negative
일부 농가의 경우 적자 경영이 불가피하다고 	negative
그런데 전망이 맞아 들어가는 듯 보이던 양돈시장은 최근 급반전을 맞았다	neutral
지난 6개월여 3천원대에 머물던 돼지 값은 최근 급상승	neutral
한돈 강세 기조는 더 강화될 것이란 예측이 나오고 	neutral
일부 전문가들은 6천원대까지 오를 것이란 전망을 내놓고 	neutral
상황이 심상치 않아서다	negative
돼지고기 생산이 줄면서 	negative
세계 돼지 값이 덩달아 뛰고 	negative
급반등세를 나타내고 	positive
세계 돈가 상승세의 영향을 받고 있을 것으로 짐작하는 이유다	neutral
유입될 가능성도 있어 돼지고기 공급 부족이 세계적인 현상이 될 가능성도 있다	negative
무엇보다 중국의 돼지고기 공급 부족 상황이 쉽게 해소될 것으로 보이지 않는다	negative
공식 통계보다 실제 발생은 더 많다는 지적이다	negative
확산되면서 이 같은 짐작을 뒷받침하고 	neutral
정부 보조가 부족해 농가에서는 ASF로 인한 살처분 이후 재입식이 어렵다고	negative
이 같은 상황을 더 부추기는 요인이다	negative
줄었다	neutral
사실이 확인됐다	neutral
가량 줄 수 있다는 분석도 나오고 	neutral
그 충격은 전 세계적일 수밖에 없다	negative
모건에서도 최근 중국 상황에 관심을 갖기 시작했다는 게 업계 전문가들의 전언이다	neutral
향후 한돈 시장에 중요한 변수다	neutral
분기까지는 출하물량 감소세가 이어질 수 있다는 전망을 내놓고 	negative
살아남은 돼지들도 그 후유증이 적지 않다	negative
종합하면 올해 양돈시장에는 하락보다는 상승을 뒷받침하는 변수들이 더 강해 올해도 돈버는 양돈을 기대할 수 있다는 게 최근 업계 관계자들의 분석이다	neutral
농가들의 노력이 필수적이라고 입을 모으고 	neutral
저작권자 	neutral
양돈타임스 무단전재 및 재배포 금지임정은다른기사 보기 68번쨰 기사입니다	neutral
전보다 소폭 늘었다	neutral
기준 전국 돼지 사육두수는 1천120만마리로 전분기 1천133만톤에 비해 1.2	neutral
감소했으며 모돈은 12월과 같은 106만3천마리를 기록했다	neutral
많았다	neutral
이 가운데 모돈은 일년전 105만8천마리보다	neutral
분기 연속 동일한 규모를 유지했다	neutral
감소했다	negative
전보다 늘었다	neutral
감소했다	negative
전년 대비로는 증가해 대조를 보였다	neutral
농장의 규모화 추세를 이어갔다	neutral
저작권자 	neutral
양돈타임스 무단전재 및 재배포 금지임정은다른기사 보기 69번쨰 기사입니다	neutral
양돈장 모돈 번식 성적이 향상되고 	positive
이유 후 육성률은 개선되지 않고 	negative
요크셔)가 전년 동기보다 0.26두 증가한 12.7두로 나타났다	neutral
다산 모돈 도입 영향으로 지난 2016년 11.82두에서 지난해 2017년 12두를	neutral
두까지 증가할 것으로 기대되고 	positive
종돈장의 총 산자수가 증가하면서 양돈장도 번식 성적 증가세를 보이고 	neutral
상승하는 등 번식 성적이 지속 향상되고 	positive
핵돈 공유가 개량 가속화의 원인으로 풀이되고 	neutral
개선되지 않고 	negative
조사 기간 중 가장 낮은 수치를 기록했다	negative
사양 기술을 속히 습득해 적용할 수 있어야 한다고 한 목소리를 내고 	neutral
70번쨰 기사입니다	neutral
4월 한돈 시장이 용두사미로 마무리 됐다	neutral
진입하며 향후 한돈 시장에 대한 기대감을 키웠다	positive
않던 돼지 값은 하락세로 방향을 틀어 26일에는 3천원대까지 낮아졌다	neutral
낮았다	neutral
기대감이 컸던 것은 무엇보다 중국발 아프리카돼지열병	negative
파 때문이었다	neutral
올해 돼지 값 전망을 상향 조정했다	neutral
이후 돼지 값은 살아나지 못했다	negative
소비가 워낙 저조한 탓에 중국발 ASF 변수가 힘을 쓰지 못하는 것으로 시장 전문가들은 분석하고 	negative
발효한 탓에 수입이 증가하는 등 나라밖 변수는 돼지 값 상승에 무게를 더하고 	negative
시세의 중요한 가늠자가 될 것으로 파악되고 	neutral
한편 4월 돼지 출하는 148만마리로 전달 143만5천마리보다	neutral
3개월만에 전년대비 증가했다	neutral
전 590만마리보다 소폭 늘었다	neutral
저작권자 	neutral
예방 캠페인을 펼쳤다	neutral
아프리카돼지열병 발생국 여행 자제 등을 당부하는 홍보물을 배포했다	neutral
작년 8월 중국	neutral
범국민적 노력이 필요하다	neutral
아프리카돼지열병 발생국 여행을 자제하는 등 국민여러분의 협조를 부탁한다	negative
71번쨰 기사입니다	neutral
있는 가운데 이들 기사들이 산지 분위기와는 동떨어져 우려된다는 지적들이 나오고 	negative
소비 증가를 더욱 어렵게 하고 	negative
지난해 동월(4천635원)은 물론 4월에 비해서도 낮은 수준에 머물고 	negative
비춰지는 돼지고기 시장 분위기는 전혀 다르다	neutral
언론들이 돼지 값 급등이 불가피하다고 	negative
더욱이 이 같은 분위기를 틈타 실제 소비자 가격도 올랐다	neutral
올랐으며 5월도 지난해 같은 기간	neutral
목살 역	neutral
전에 비해 비싸게 팔리고 	negative
여파로 실제 돼지 값이 오른 것으로 보기에 충분한 상황	neutral
한돈 대체 소비를 부추기고 	negative
한돈 소비는 가격 상승과 함께 수입육과의 가격 격차 확대 속에 더욱 위축될 수 있는 상황이다	negative
농가들이 큰 수익을 올리는 것처럼 비춰져 답답하다	negative
소비 홍보에 적극 나서야 한다는 게 업계 전문가들의 당부다	neutral
지속적으로 산지와 소비시장과의 연동성을 높일 수 있는 방안도 추진돼야 할 것으로 지적되고 	negative
저작권자 	neutral
작업 물량을 감축하고 	positive
육가공업체 관계자들이 참석한 가운데 최근 국내 돈육 시장에 대한 동향분석회의를 개	neutral
했다	neutral
없어 여전히 시중에 덤핑 물량 나타나고 	negative
판매가 나아지지 않을 것으로 보여 현재 상황을 유지할 것	negative
육가공업체의 작업 감축영향으로 도매시장 출하물량이 증가할 것으로 전망	negative
하락했다	negative
72번쨰 기사입니다	neutral
아프리카돼지열병 해결의 실마리를 찾겠습니다	neutral
적극적으로 해결책을 모색하는 자리로 만들겠다고 	neutral
전문가 집단이 참여하는 순수한 학술 대	neutral
농가들의 참여가 제한된다	neutral
베트남 등 발생국의 경우 발표자 등 일부 인원 외 최소화된 인원으로 참석을 제한하는 한편 모든 참석자들에 대해 입국 시 수하물 검사	neutral
발표하는 장이 마련됨으로 급변하는 양돈산업에 새로운 방향성을 제시할 수 있는 기회가 될 것	neutral
발생 국가의 참여가 제한된다	neutral
긴급회의를 진행하고 고심 끝에 발병국의 참가를 전면 제한키로 의결했다	neutral
중국 - 38개 업체 49개 부스 규모	neutral
박람회 현장을 강력한 방역태세를 갖추기로 했다	neutral
예방 자료를 사전 배포 및 숙지토록 해 국경 검역부터 ASF 차단 절차를 진행할 예정이다	neutral
대인방역시설을 방역기관과 연계해 빠짐없이 준비하며 이에 더해 전시장 입장 시 덧신 착용의 의무화 등을 검토 중에 있다	neutral
73번쨰 기사	neutral
니다	neutral
예상됐지만 출하물량이 늘어 전년 대비 약세 흐름은 이어질 것으로 전망됐다	negative
대비 상승세로 전환할 것으로 내다봤다	neutral
전(5천192원)에 비해서는 낮을 것으로 분석했다	neutral
수입량은 국제 돼지고기 가격 상승으로 지난해보다 적은 3만6천톤이 전망됐다	neutral
않을 경우 국내 대미국 돼지고기 수입이 원활해질 가능성이 있다고 	neutral
가격 하락을 부추길 것으로 내다봤다	negative
추후 대국민 홍보 캠페인을 진행키로 했다	neutral
안)에 대해 논의했다	neutral
이 같이 예산을 증액했다	positive
발생으로 인한 질병 확산 우려 및 국내	negative
입 방지를 위해 범국민적 방역 협조 및 정부의 신속한 정책 개선 요구를 위한 	neutral
오는 21년 11월까지 임기를 연장키로 했다	neutral
한편 이날 일부 위원은 한돈자조금이 한돈 가격 안정을 위한 사업들을 보다 더 확대해야 한다고 	neutral
수급 안정 예비비로 적립되고 있는 수급비가 적시에 활용되지 못한다고 지적하며	negative
한돈 할인판매를 진행했다	positive
이상 할인된 1만원에 판매하는 행사를 진행했다	positive
한돈 삼겹살 시식회도 진행해 인근 직장인들과 청계천을 찾는 관광객들이 저렴한 가격에 한돈을 구입하고 한돈을 홍보했다	positive
국민 여러분의 협조를 부탁하는 의미에서 감사의 마음을 담아 이번 할인 행사를 마련했다	positive
74번쨰 기사입니다	neutral
구제역 항체 형성률도 하락하고 	neutral
농림축산식품부에 따르면 구제역 평균 항체 형성률	neutral
수준을 밑돌고 	negative
돼지 항체 형성률은 지난해 7월부터 11월까지 70	neutral
대까지 상승했다	neutral
항체 형성률이 하락하고 	negative
이는 일부 농가들이 백신 접종을 소홀히 한 영향	negative
구제역 발생 우려가 있다	negative
철저한 방역 관리를 당부했다	neutral
발생하면 소비자들이 한돈 소비를 크게 줄일 것으로 조사됐다	negative
협회 전국 한돈지도자 연수회에 참석해 ‘향후 세계 국내 돼지가격 전망’이라는 주제로 특강을 진행	neutral
소비자를 대상으로 설문을 실시한 결과 73.3	neutral
일 것이라고 응답했다	neutral
돼지고기 안전성 의심에 따른 것으로 풀이된다	neutral
발생 여부로 국내 소비자들은 아프리카돼지열병 발생 시 돼지고기 소비를 감소시킨다는 의견이 압도적으로 많기 때문에 ASF 국내 발생 방지를 위한 국경검역	neutral
한편 국제수역사무국	neutral
남쪽으로 전파되는 것을 막기 위한 추가적인 방역조치를 실시키로 했다	neutral
운영하고 축산 관련 차량 등에 대해 방역을 실시키로 했다	neutral
아프리카돼지열병 감염 여부를 7일까지 확인키로 했다	neutral
돼지 이동제한 등도 검토할 계획이다	neutral
야생 멧돼지 차단 조치도 확대한다	neutral
그 외 지역은 단계적으로 확대 설치키로 했다	neutral
저작권자 	neutral
양돈타임스 무단전재 및 재배포 금지임정은	neutral
기사 보기 75번쨰 기사입니다	neutral
협회가 오는 8월 부산에서 개최 예정인 ‘2019 부산 아시아양돈수의사대회	neutral
취소를 촉구했다	negative
며 ASF의 위협이 코 앞 까지 다가온 상황에서 APVS의 즉각 취소를 촉구했다	negative
전염 우려로 전격적으로 취소된 사례를 교훈 삼아야 할 것이다	negative
바 있어 입장 변화에 대한 귀추가 주목되고 	neutral
국내 유입을 막기 위해 지정한 특별관리지역이 10개에서 14곳으로 확대된다	neutral
양돈농가의 잔반 자가 급여를 금지키로 했다	neutral
대응 강화방안을 확정했다	neutral
동두천 추가) 확대키로 했다	neutral
이와 함께 남은 음식물 자가 급여 농가 173개소를	neutral
이를 금지토록 한다는 계획이다	neutral
범부처 총력 대응을 위해 농림축산식품부 차관을 단장으로 	neutral
분야별로 협력체계를 구축한다는 계획이다	neutral
지자체 합동 영상회의를 매일 개최해 방역 상황을 점검하고 이달 중으로 접경 지역 농가와 관계기관 합동 가상방역 훈련도 실시키로 했다	neutral
이와 함께 민통선 이북지역 멧돼지 포획을 강화하고 포획된 멧돼지는 ASF 검사키로 했다	neutral
소독하고 	neutral
혈청검사 결과 전두수 ASF 음성으로 확인됐다	neutral
농가의 울타리 설치를 지원해 줄 것을 요청했다	neutral
정부에 건의했다	negative
기존 사업 신청 절차를 간소화하고 	neutral
즉시 수렵이 허용되도록 관련 절차를 간소화해야 한다고 	neutral
저작권자 	neutral
양돈타임스 무단전재 및 재배포 금지임정은다른기사 보	neutral
76번쨰 기사입니다	neutral
가격 약세로 상반기 양돈장 수익이 전년 대비 감소한 가운데 생산성도 정체되면서 올해 전반적으로 양돈 경영에 빨간 불이 켜졌다	negative
하락했다	negative
겨우 지난해 생산비 수준을 유지	neutral
올 상반기 농가 수익은 본전이다	positive
3월 5천원 각각 적자를 형성한 것으로 나타났다	negative
가격 상승 폭이 낮아 수익을 올리기에는 역부족이다	negative
전망되면서 올해 양돈 경영 수지는 전년에 비해 크게 낮아질 것으로 예측된다	negative
이런 상황에서 생산성이 낮은 농가는 경영 위기에 직면할 것으로 예측된다	negative
평균 하위 농가들의 생산 성적이 지난해보다 더 하락한 것으로 분석됐기 때문이다	negative
최근 한돈 소비 형태로 볼 때 하	neutral
기도 상승하기 어렵다	negative
77번쨰 기사입니다	neutral
캠핑 열기 확산에 불을 지폈다	neutral
캠핑 페스티벌’을 성황리에 개최했다	positive
이번 행사는 캠핑 문화를 즐기는 캠핑족들에게 우리 돼지 한돈의 맛과 우수성을 알리고	positive
상당 한돈 패키지와 한돈 기념품 등 푸짐한 상품을 제공했다	positive
많은 참가자들에게 큰 호응을 얻었다	positive
선물세트를 증정했다	positive
자조금은 참가자들의 뜨거운 호응에 힘입어 	positive
78번쨰 기사입니다	neutral
전국 모든 양돈장을 대상으로 아프리카돼지열병	neutral
국내 유입 방지를 위한 최고 수준의 방역조치의 일환으로 현재 추진 중인 	positive
정밀 검사는 전국 모든 돼지농장 약 6천300여 농가를 대상으로 내	neutral
곳은 검사에서 제외된다	neutral
정밀 검사를 단계별로 실시한 결과 모두 ‘음성	neutral
정부가 구제역 방역 사각지대 해소를 위해 농가 책임 강화 및 현장 관리를 확대키로 했다	positive
개선하기 위해 지난달 28일 	neutral
목적이 있다고 	positive
축협에서 백신 접종 여부를 확인토록 했다	neutral
경우 확인검사 없이 즉시 과태료를 부과키로 했다	neutral
농가 책임 방역 강화를 위해 항체양성률 검사 결과가 최초 1회 미흡 시에는 과태료뿐만 아니라 백신접종 명령을 하고	neutral
경우 도축 출하를 제한키로 했다	neutral
상향하는 등 패널티도 강화한다	negative
시설현대화 등 축산 정책자금 지원도 제한키로 했다	neutral
축소키로 했다	neutral
구제역 방역 초동 조치의 실패로 이어질 수 있다고 우려하고 	negative
79번쨰 기사입니다	neutral
약세가 지속된 올 상반기 돼지고기 시장에 수입 돼지고기까지 가세해 시장 어려움을 가중시켰다	negative
수입육의 시장 잠식이 더욱 심화된 것으로 파악되고 	negative
줄었다	neutral
적었다	neutral
이처럼 상반기 수입량이 지난해 대비로는 감소했지만 	neutral
가량 많았으며 월평균으로 따지면 4만톤 이상 들어온 셈이다	neutral
특히 한돈 하락시기에는 수입량이 크게 감소했던 전례에 비춰볼 때 올해는 국내 시장 상황과 상관없이 수입물량이 일정 수준을 유지한 것이다	neutral
나머지 부위들은 소폭 줄거나 오히려 크게 늘었다	neutral
특히 구제역 백신 접종 이후 한돈 목심은 시장서 외면 받고 	negative
) 늘었다	neutral
준 반면 독일과 스페인산은 각각 4만5천톤	neutral
저작권자 	neutral
산업이 수입육이 아닌 ‘가짜 고기	negative
그 중 하나로 선정됐다	neutral
비교하면 무려 146.3	neutral
이는 최근 대체육 관련 상품들이 국내에도 본격적으로 출시되면	neutral
관심이 부쩍 높아진 때문으로 파악되고 	neutral
사회적 가치(온실효과	neutral
부정	negative
관심 증가와 함께 기존 축산업의 부정적 측면과 비교되면서 상대적으로 후한 평가를 얻고 	positive
대체 육류가 될 것으로 전망한 바 있다	neutral
저작권자 	neutral
백신이 공급되기 시작하면서 농가들의 예방 접종 업무 효율성이 높아질 것으로 기대되고 	positive
용량으로는 백신 접종 업무의 효율성이 떨어지고 	negative
이에 한돈협회는 현장 의견을 수렴	neutral
실험을 거쳐 늘어난 용량의 백신 제품을 선보였다	neutral
지부에서 적극 홍보할 것을 당부했다	neutral
80번쨰 기사입니다	neutral
국내 돼지고기 시장 경색의 주요 원인이 되고 	negative
각각 증가했다	neutral
늘었다	neutral
감소했다	negative
지난해와 마찬가지로 국내 수요 이상 수입이 이뤄졌다는 얘기다	neutral
문제는 이 같은 재고 적체는 한돈 소비와 가격 상승을 억제하는 주요 원인이 될 수 있다는 것	negative
수입육 업체들이 재고 과다로 인한 자금난이 심화되고 	negative
한돈 소비를 한층 더 어렵게 하고 	negative
저작권자 	neutral
기사 보기  한돈자조금 및	neutral
하반기 내내 전방위적 홍보 활동을 전개키로 했다	neutral
소비가 부진하고 	positive
수급 조절 예비비 총 16억원을 투입해 다양한 소비 촉진 사업을 전개키로 했다	neutral
이후 한돈 소비 촉진 행사를 대대적으로 진행할 것으로 알려졌다	positive
아프리카돼지열병(ASF) 바로 알리기	neutral
추석 선물세트 등 시기에 맞는 기획전을 지속적으로 펼칠 계획이다	positive
간편식 제품 개발에도 박차를 가한다는 계획이다	neutral
홍보 콘텐츠 공모전도 시작했다	neutral
중장기 소비촉진 계획안 마련에도 적극 반영한다는 방침이다	neutral
병원 등 단체급식소에 한돈 메뉴를 제공하는 소비촉진 활동도 지속적으로 이어	neutral
81번쨰 기사입니다	neutral
분기도 외식경기가 신통치 못했다	negative
분기 현재 외식산업 경기를 진단	neutral
전년 동기 대비 매출액이 감소한 업체가 더 많았다고 	negative
낮아 단계적 하락세를 보이고 	negative
분기 64.54로 하락세가 포착됐다	negative
분기 미래경기전망지수 조사에서도 매출액 감소를 예측한 업체가 많은 것으로 조사됐다	negative
경기지수에 부정적 영향을 미치고 	negative
저작권자 	neutral
양돈타임스 무단전재 및 재배포 금지임정은다른기사 보기 82번쨰 기사입니다	neutral
8월 한돈 4천원대는 유지할 수 있을까	neutral
계속된 한돈 약세에 휴가철임에도 4천원대도 무너지는 것은 아닌지 우려가 높아지고 	negative
양돈관측을 통해 8월 평균 돼지 도매가격이 4천100	neutral
낮은 수준이다	negative
이마저도 자신하기 어렵게 됐다	negative
무엇보다 매년 돼지 값 흐름 때문이다	neutral
돼지 값이 더 낮았다	negative
가량 하락했다	negative
기준)이 4천137원으로 아슬아슬하게 4천원대를 턱걸이하고 	neutral
시세는 25일에는 3천788원까지 밀려나면서 4천원대에서는 더 멀어졌다	neutral
더구나 8월 등급판정두수는 131만	neutral
난해 동월 130만마리에 비해 1	neutral
7월 일평균 등급판정두수	neutral
증가세를 유지한다면 돼지 값에 대한 하락압력은 더 높아질 수밖에 없다	negative
전년 대비 1.8% 많을 것으로 전망했다	positive
수입량은 감소할 것이란 전망이다	negative
감소한 2만6천톤에 그칠 것으로 내다봤다	negative
경우 가격 반등 가능성이 있다고 	neutral
저작권자 	neutral
양돈타임스 무단전재 및 재배포 금지임정은다른기사 보기 83번쨰 기사입니다	neutral
NULL84번쨰 기사입니다	neutral
폭염이 시작되면서 돼지 폐사 피해가 늘고 	negative
가축 폐사두수는 132만1천마리로 집계됐다	neutral
76만4천마리) 증가한 수치다	neutral
이상 폐사가 늘었다	negative
기록했던 지난해 수준과 비교하면 폭염피해가 아직 크지 않은 상태	negative
더위가 시작되면서 이처럼 폐사도 빠르게 늘고 	negative
저작권자 	neutral
양돈타임스 무단전재 및 재배포	neutral
육박하며 역대 7월 가운데 가장 많았다	neutral
각각 늘었다	neutral
크게 증가한데다 역대 7월 출하 중 역대 최고치다	negative
각각 하락했다	negative
더위가 심하지 않았던 것도 한 원인이다	positive
기상청에 따르면 7월 전국 폭염일수는 3.3일로 18년	neutral
평년(3.9일)에 비해서도 0	neutral
6일 적었다	neutral
늘었다	neutral
저작권자 	neutral
양돈타임스 무단전재 및 재배포 금지임정은다른기사 보기 85번쨰 기사입니다	neutral
검사가 완료된 가운데 모두 음성으로 확인됐다	neutral
시작으로 전국 양돈농장을 대상으로 단계별로 검사를 확대 실시했다	neutral
완료된 검사에서 모두 음성 판정이 나온 것이다	neutral
검사와 함께 내년도 양돈장	neutral
상시검사를 위한 4억원의 예산 확보를 추진할 계획이다	neutral
저작권자 	neutral
마늘의 소비 촉진을 위해 동분서주하고 	neutral
농협은 지난 14일 구내식당에서 돼지 도매가격과 양파	neutral
마늘 가격 하락으로 어려움을 겪고 	negative
응원의 메시지를 전하고자 축산경제대표이사	positive
건강더하기’ 캠페인을 펼쳤다	positive
하락했다	neutral
주된 가격 하락의 원인으로는 경기 위축 심화	negative
한돈에 곁들여 먹는 양파 마늘 가격도 동반 폭락했다	negative
이상 각각 폭락했다	negative
돼지고기 소비가 줄면서 	negative
돼지고기와 양파	neutral
마늘 가격하락으로 시름하고 있는 농업인들의 마음을 임직원 모두가 통감해야 할 때	negative
마늘을 많이 애용하여 우리 농업인에게 힘을 보태 주시길 부탁한다	neutral
86번쨰 기사입니다	neutral
시세 하락에도 외식시장에서 한돈의 설자리는 더 좁아졌다	negative
대신 수입산의 비중이 더 높아졌다	neutral
이 가운데 한돈 비중도 낮아진 것으로 나타났다	neutral
감소했다	negative
다른 축산물의 구매도 준 것으로 조사됐다	neutral
P 낮아졌다	neutral
한돈 외식 소비는 더욱 위축된 것으로 나타났다	negative
저작권자 	neutral
양돈타임스 무단전재 및 재배포 금지임정은다른기사 보기 87번쨰 기사입니다	neutral
소비하는 돼지고기가 점차 줄고 	negative
줄었다고 	neutral
준 탓이다	neutral
소비되는 돼지고기가 지속적으로 감소세를 보이고 	negative
이는 최근 몇 년 사이 1인 가구의 증가와 간편	neutral
조리하던 방식에서 보다 간편하게 소비할 수 있는 형태로 변화하고 	neutral
저작권자 	neutral
한돈과 수입 돈육의 차별화는 여전히 요원하다는 지적이다	negative
대의원들의 의견을 수렴했다	neutral
인지하는 비율이 매해 상승하고 	neutral
소비 홍보에 주력할 계획이라고 밝혔다	positive
전국 도별 대의원들은 한돈 인지도 향상에는 공감하면서 여전히 한돈과 수입 돈육의 차별화 홍보는 미진하다고 	negative
인지하지 못하고 	negative
행사의 변화를 주문했다	neutral
기존 앞	neutral
뒷다리 저지방 부위 기부 중심에서 실질적으로 소비자에게 혜택을 줄 수 있도록 한돈 할인	positive
행사 비중을 높여야 한다는 것	neutral
농가에 더 도움이 될 것	positive
한돈 소비 홍보에 더 박차를 가하겠다고 	neutral
주변 농장도 관리 대상에 포함된다	neutral
행정예고했다	neutral
바이러스 순환여부 확인검사 등 관리가 이뤄졌던 것을 반경 500m 이내 농장으로 확대했다	neutral
바이러스 순환을 선제적으로 차단하기 위한 조치라는 설명이다	neutral
공동방제단도 투입돼 의심농가 주변을 소독해 오염원을 조기에 제거한다는 방침이다	neutral
이번 개정안에는 제도적 미비점도 함께 보완됐다	neutral
방역지역 설정기준을 명확히 하고 	neutral
의견을 수렴할 계획이다	neutral
저작권자 	neutral
  휴가철에도 기를 펴지 못했던 8월 돼지 값이 뒷심을 발휘하	neutral
평균 4천원대를 기록했다	neutral
올랐다	neutral
돈가는 중반까지는 3천원대를 벗어나지 못하다	negative
마지막 2주에 뒤늦게 상승했다	neutral
차이가 크게 벌어졌다	neutral
출하물량을 보면 더 그렇다	neutral
특히 돼지 값이 오르기 시작한 19일 이후만 보면 7만두에 육박한다	neutral
역대 8월 중 출하물량이 가장 많았다	neutral
이처럼 많은 출하물량에도 돼지 값이 오르고 	neutral
최근 아프리카돼지열병(ASF)으로 급등하고 	negative
저작권자 	neutral
양돈타임스 무단전재 및 재배포 금지임정은다른기사 보기 88번쨰 기사입니다	neutral
올해 종돈 수입 물량이 급감하며 수입 종돈 의존도가 낮아지고 	negative
재작년 2천842두보다	neutral
크게 감소한 물량이 들어왔다	neutral
올해 종돈 수입 물량은 최근 5년간에 비해 가장 적게 들어올 것으로 예측되고 	neutral
올해 수입된 종돈을 국가별로 살펴보면 캐나다에서 512두	neutral
두가 들어왔다	neutral
지난해부터 이들 종돈장들의 수요 감소로 종돈 수입 두수가 지속 급감하고 	negative
추가 수입없이 종돈 개량에 박차를 가하고 	neutral
확대됐음에도 구제역 항체 형성률이 하락하는 기현상이 나타나고 	negative
의견이 분분하다	neutral
P 하락했다	negative
업계간 의견이 엇갈리고 	negative
이는 일부 농가들이 백신 접종을 소홀히 한 영향	negative
백신 변화가 더 많은 영향을 주고 	neutral
토로했다	negative
경기도	neutral
백신 효능에 대해 의문을 제기했다	negative
접종 방법에만 전가하는 것은 바람직하지 못하며	negative
광고도 한돈 이미지 광고에서 먹는 광고로 변화됐다	neutral
타이틀로 제2의 전성기를 누리고 	neutral
신선하고 맛있는 우리돼지 한돈을 익살스럽게 표현했다	positive
사랑받는 계기가 되길 기대한다	positive
89번쨰 기사입니다	neutral
추석이 한돈 소비 성수기로 자리매김하는 것일까	neutral
소비자 패널의 추석 농식품 구매패턴의 변화를 분석한 결과를 발표했다	neutral
이에 따르면 9년간 추석 전 2주간 돼지고기 구매액은 평소보다	neutral
이 같은 추세가 더 두드러지는 것으로 분석됐다	neutral
최근 크게 높아졌다	neutral
돼지고기도 추석이 소비 호재가 되고 	positive
있는 추세와도 연관이 있는 것으로 짐작되고 	positive
최근 상승세를 보이며 4천600원대까지 올랐다	positive
저작권자 	neutral
기사 보기  하반기 한돈 약세 전망 속에 업계 외부	neutral
가격 상승으로 이어질 것으로 내다봤다	negative
국제 가격 급등은 시간문제라고 지적했다	negative
가격 상승도 시간문제라고 김 연구원은 주장했다	negative
그동안은 살처분한 돼지들이 고스란히	negative
이 재고가 소진되면 공급 절벽에 도달할 수밖에 없는데 	negative
투자증권의 조미진 연구원도 중국의 최근 돼지 값 급등을 주목하며 중국의 돼지고기 공급 부족은 글로벌 수급 불균형으로 이어질 가능성이 크며 국내 시장에는 연말 또는 하반기부터 그 영향이 나타날 것이라고 전망했다	negative
미만으로 떨어지고 	neutral
전년 대비 낮을 것으로 내다봤다	negative
저작권자 	neutral
받은 첫 사례가 발생했다	negative
이에 농가들은 행정편의주의의 과도한 행정조치라고 반발하고 	negative
행정 처분을 내린 것으로 알려졌다	negative
농가들이 긴장하고 	negative
이처럼 전국 양돈장이 촉각을 곤두세우는 이유는 A시가 양돈장 냄새 규제에 대해 악취방지법을 적용하지 않고	neutral
행정 처분을 적용하고 있으나	neutral
위반 사항임에도 불구 가축분뇨관리법을 적용했다	negative
가축분뇨관리법 적용의 문제점은 악취 방지법의 경우 배출 허용 기준 초과에 대한 상세한 처벌기준과 행정 처분 기준이 있는 반면	negative
전체 농가들의 사육 의지가 저하될 것으로 우려되고 	negative
일선에서 혼선이 야기되고 	negative
90번쨰 기사입니다	neutral
의심축 신고 정밀검사 결과 양성으로 확진됐다	negative
또한 파주서	neutral
의심신고 역시 확진으로 판정됐다	neutral
농림축산식품부는 23일 오전 김포의 한 양돈농장에서 모돈	neutral
정밀 검사한 결과 아프리카돼지열병으로 확인됐다고 	negative
이에 따라	neutral
연천에 이어 국내 세 번째 발병 사례가 됐다	negative
특히 한강 이남에서 발병하는 첫 사례가	neutral
방역당국이 긴장하고 	negative
연천 농장으로부터 45.8㎞ 각각 떨어져 있다	neutral
김포 농장은 모돈 180마리를 포함해	neutral
지 1천800마리를 기른다	neutral
또 농림축산식품부는	neutral
23일중점관리지역	neutral
위치한	neutral
소재	neutral
돼지농장에서	neutral
신고	negative
1건이	neutral
정밀 검사 결과 확진으로 판정되면서 	negative
발생 농장은?	neutral
농장주가	neutral
3두	neutral
증상을	neutral
확인하여	neutral
파주시에	neutral
의심신고를	neutral
파주시 적성면	neutral
소재 농장 은 돼지 약	neutral
6.9㎞으로 기존 방역대에 위치하고 	neutral
91번쨰 기사입니다	neutral
사육돼지서 야생멧돼지로 전파 시 심각한 상황에 직면할 것이라는 주장이다	negative
방역 대책 회의를 진행하고 사육돼지에서 야생멧돼지로의 전파 예방 대책에 대해 논의했다	neutral
상재화로 접어들 우려가 높다고 	negative
지역으로 방역대를 설정해 멧돼지 개체수를 조절해야 한다고 	neutral
멧돼지 포획 대신 사체 수색 강화를 중심으로 포획틀을 사용해 멧돼지 수를 조절이 필요하다고 	neutral
확산될 위험	negative
있기 때문	neutral
개체수를 절반 이상으로 줄이기 위한 모든 방법을 동원해야 한다는 주장이다	neutral
방역 대책을 공동으로 추진할 수 있도록 해야 한다고 	neutral
농림축산식품부는?	neutral
30일	neutral
화성시	neutral
1개소	neutral
가축위생방역지원본부의?	neutral
전화예찰	neutral
농장주의	neutral
가족이	neutral
의심축	negative
1두가	neutral
유산	neutral
신고됐다	neutral
정밀검사결과 음성으로 확진됐다	neutral
반경	neutral
2개소	neutral
500m～3㎞내에는	neutral
24,200여두가 사육 중이었다	neutral
돼지 출하가 줄면서 	negative
높을 것으로 내다봤다	neutral
발생 영향으로 가격 변동성이 클 수 있다고 	negative
돼지출하가 많지 않기 때문이다	negative
적을 것으로 분석됐다	neutral
농경연은 이에 대해 여	neutral
낮아 증체 지연이 적은 것으로 추정된다고 	positive
홍수 출하 염려가 적다는 것이다	positive
여기다 수입량도 국제 돼지고기 가격 상승으로 전년(2만8천톤)보다 감소한 2만6천톤으로 전망됐다	negative
이후 돼지 출하는 사육두수 증가 영향으로 지난해보다 많을 것으로 추산됐다	neutral
전년 대비 2.2% 많을 것으로 내다봤다	neutral
전년(20만5천톤)보다 줄 것으로 전망됐다	neutral
저작권자 	neutral
양돈타임스 무단전재 및 재배포 금지임정은다른기사 보기 92번쨰 기사입니다	neutral
김포 전체 돼지를 수매	neutral
살처분키로 했다	neutral
산업을 위축시킬 것으로 우려되고 	negative
수매와 예방적 살처분을 조속히 추진키로 했다	negative
연천군의 경우에도 조속히 논의해 발생농장 반경 10km	neutral
내 돼지 대상으로 수매와 예방적 살처분을 추진할 계획이다	neutral
이에 따라 김포 및 파주 지역 돼지 수매는	neutral
지육단가를 곱한 가격으로 정산할 계획이라고 밝혔다	neutral
농가들은 크게 반발하고 	negative
토로했다	negative
일정 기간 재입식이 어려워지는 등 폐업에 준하는 상당한 피해를 감수해야 하는 상황	negative
이에 전국의 한돈 농가들은 정부의 특단의 조치가 일부 선량한 농가들의 피해를 가중시키는 조치라며 예방적 살처분 농가의 경우 폐업 수준에 준하는 보상안 제시 및 재입식 기준 완화를 먼저 제시해야 한다고 	negative
산업 위축도 불가피할 것이라고 강조하고 	negative
고양 내 돼지 도축을 위해	neutral
경기 남부권 도축장으로 출하가 일시적으로 허용됐다	neutral
협회에 따르면	neutral
경기북부 중점관리지역 내 도축물량이 급증함에 따라 경기 양주	neutral
출하가 허용됐다고 	neutral
불과해 수매도축물량 포화로 농가의 돼지 출하에 일시적인 어려움이 있었다	negative
정부가 수용했다	neutral
고양내 돼지농가는 남양주 지정도축장으로 출하가 가능하다	neutral
이후 경기북부권 돼지를 나중에 도축하는 방식으로 진행된다	neutral
남양주를 제외한 경기남부권내 돼지는 동 기간동안 남양주 도축장으로 출하가 불가하다	neutral
환경검사에서 이상이 없는 경우 경기남부권 돼지 도축을 허용할 방침이라고 설명했다	neutral
93번쨰 기사입니다	neutral
강력 촉구했다	negative
협회는	neutral
합리적 보상책 마련을 촉구하는 릴레이 1인 시위를 청와대	negative
검출된 만큼 정부의 집돼지 몰살정	negative
강력히 촉구했다	negative
촉구했다	negative
협회가 주장하는 요구는 다음과 같다	neutral
살처분 정책을 즉각 중단하라	negative
살처분 정책을 즉각 중단하라	negative
생존권을 보장하라	neutral
약속을 먼저 선행하라	neutral
환경부는 야생멧돼지 발생의 책임을 지고 전부 사살하라	negative
전국 야생멧돼지 포획 및 사살을 즉각 시행하라	negative
조로 릴레이로 진행될 예정이다	neutral
농가들이 릴레이 1인 시위를 진	neutral
할 예정이다	neutral
17일 ASF 살처분 말살정책 중단 및 피해농가 보상촉구 전국 한돈농가 총궐기대회	negative
10월 18일 ASF 피해지역 비상대책위원회 집회	neutral
경기도 북부청사 앞) 등을 개최할 계획이라고 밝혔다	neutral
94번쨰 기사입니다	neutral
○	neutral
발생과 관련에 대해 조언했다	neutral
운영하는 아프리카돼지열병 표준연구소 소장을 맡고 	neutral
호세 박사와 인터뷰를 일문일답 형식으로 정리했다	neutral
한국 정부의 지역 단위 살처분 확대 정책에 어떻게 생각하나	neutral
한국의 지역 단위 살처분 정책은 사실 한국에 도착해서 	neutral
한국이 유일하다	neutral
예방 살처분 범위는 최대 5~10km를 권장하고 	neutral
역학과 관련돼 있는 농장에 한해서 	neutral
역학관계가 명확해야 살처분 확대 정책이 실효성이 높다	neutral
지역 단위 살처분은 조금 과하다는 생각이 든다	negative
■국내 ASF 발생 유입 원인은	neutral
가정을 통해 유추해볼 수 있다	neutral
한국은 ASF 발생국인 중국	neutral
관광객이 수없이 드나든다	neutral
특히 중국 관광객 특성상 음식물을 소지하는 습성이 있기 때문에 때마침 ASF 바이러스가 함유된 축산물을 어떤 경로를 통해 발생 농가의 돼지가 먹어 ASF가 발생했을 수 있다	neutral
한국 사람들이 유력하게 생각하는 북한을 통한 발생의 경우도 가능성은 높다	neutral
국내 발생 농가로 전파됐을 가능성도 있다	negative
바이러스 매개체로 충분하다	neutral
발생 원인도 중요하지만 발생 농장간 역학 관련 파악이 더 중요하다	neutral
앞으로 중요한 과제다	neutral
■ASF 차단 방역 방법은	neutral
농가 단위에서는 이중 펜스 설치 등 야생동물과의 접촉을 막아야 한다	neutral
유럽의 경우 멧돼지를 통제한 국가는 청정화에 성공한 반면	negative
멧돼지를 단계적으로 제거한 결과 청정국으로 거듭난 것이 좋은 예이다	neutral
멧돼지 접근을 막아야한다	neutral
이중펜스가 도움이 된다	neutral
관리 강화가 중요하다	neutral
차단 방역이 중요한데 	neutral
된다	neutral
농장 출입 자체를 금지시켜야 한다	negative
■재입식을 위한 요건은	neutral
정도 가져야 한다	neutral
확인되면 음성농가로 판단할 수 있다	neutral
이러한 감시돈 검사는 외국 기준으로 원래 키우던 돼지 마릿수의 10	neutral
이 모든 절차를 거친 후에야 재입식해야 한다	neutral
■백신 상용화는 언제 쯤	neutral
아프리카돼지열병 백신은 개발됐지만 완성형은 여전히 시간이 걸릴 듯하다	neutral
상용화하기까진 최소 2년은 소요될 것으로 전망된다	neutral
방어율을 보이고 	positive
얼마나 먹여야 되는지에 대한 실험이 진행 중이다	neutral
아프리카돼지열병 발생 현황	negative
파주 1건 등 모두 12건으로 늘었다	negative
지점서 발견됐으며 17일는 파주에서도 발견되면서 	neutral
확산 우려가 커지고 	negative
국방부는 부처 합동 긴급 대책을 마련했다	neutral
관리지역으로 구분해 각 지역별로 차별화된 조치를 시행한다	neutral
포획틀과 포획트랩을 확대 설치키로 했다.	neutral
집중 포획에 돌입했다	neutral
지급하는 방안도 추진키로 했다	neutral
차단지역 역시 야생 멧돼지 전면 제거가 기본 방향이다	neutral
저작권자 	neutral
전국 단위의 대대적인 판촉행사를 진행했다	neutral
대대적인 할인행사를 펼친다	positive
인증점에서 할인행사를 진행한다	positive
돈까스 등 주 메뉴 1인분당 2천원을 할인하고 	positive
분당 4천원씩 할인해 판매한다	positive
할인된 가격에 구매할 수 있다	positive
대규모 할인행사도 진행한다	positive
할인된 1천350원에 판매한다	positive
이상 저렴하게 판매키로 했다	positive
95번쨰 기사입니다	neutral
협회에 기탁했다	neutral
농장의 차단 방역을 무력화시키는 쥐를 박멸하여 내 농장을 ASF로부터 지켜내자는 뜻에서 구서제를 한돈농가에 전달하게 되었다	positive
일수록 대한민국 축산업의 이름으로 관계자들 서로가 도움으로써 위기를 슬기롭게 극복해 나가자고 	positive
정도의 쥐가 서식하고 	neutral
감염된 부산물을 농장안으로 전파시키는 요인이 될 수 있으므로 야생고양이 출몰을 막기 위해서라도 농장 내외부의 구서작업은 필수다	negative
협회가 정부의 안일한 야생 멧돼지 관리를 비판하며 환경부장관 사퇴를 촉구하고 	negative
협회는	neutral
산업을 벼랑 끝에 서게 한 책임을 환경부가 질 것을 주장했다	negative
성토했다	negative
환경부가 지금과 같은 안일한 대책으로 일관한다면 현 ASF 상황을 초래한 환경부장관의 사퇴 운동을 전개하겠다고 	negative
정부에 건의키로 했다	neutral
농가 차입금의 정책자금 대환 등 보상 대책 건의안을 마련해 정부에 전달키로 했다	neutral
협회는 살처분 보상금 현실화를 요구했다	neutral
가격이 3천원대로 하락하면서 	neutral
더 피해를 입는 역차별 상황이 발생하고 	negative
발생한 전월	neutral
이 기간 동안 정상 입식 지연 보상안을 요청했다	neutral
보상안 사례를 참고했다	negative
보상책을 정부에 요구키로 했다	neutral
동진을 저지하기 위해 광역 울타리가 설치된다	neutral
바이러스의 확산을 차단하기 위해 긴급대책을 발표했다	neutral
바이러스의 확산 가능성을 원천적으로 차단하기 위해 지난 10월 13일 발표한 긴급대책을 보다 강화한 것이라고 본부는 설명했다	neutral
이동성이 높아질 수 있다는 점 등 다양한 상황 변화와 여건을 종합적으로 고려하여 마련됐다	neutral
강화된 대책은 다음과 같다	neutral
멧돼지의 남하와 동진을 차단할 수 있는 광역 울타리를 파주부터 고성까지 동서를 횡단하여 구축하기로 했다	neutral
현재까지는 감염 개체를 발생지점에 고립시키기 위해 반경 3킬로미터 내외의 국지적 울타리를 2단으로 설치하고 	negative
권역도 설치에 들어갈 계획이다	neutral
가속화하면서 멧돼지의 이동은 효과적으로 차단할 계획이다	positive
멧돼지를 남에서 북으로 몰아가는 방식으로 총기포획을 허용키로 했다	neutral
농가의 불안을 해소하기 위해	positive
완충지역의 총기포획	neutral
총기포획을 실시하고 	neutral
이 경우에도 남에서 북으로의 포획 등 기본원칙은 유지된다	neutral
총기포획을 추진한다	neutral
울타리까지 설치되면 아프리카돼지열병의 확산 우려가 크게 낮아질 것으로 보고 11월 7일부터 제한적 총기포획을 추진할 예정이다	neutral
한편	neutral
규모의 정밀 수색팀을 발생지역에 집중투입하여 멧돼지 폐사체를 촘촘하게 수색할 계획이다	neutral
화천은 전략적 총기 포획을 실시하고 동서 광역울타리를 신속히 설치하겠다	neutral
필요한 조치들을 신속히 추진해 줄 것을 당부했다	neutral
96번쨰 기사입니다	neutral
전년 대비 감소세로 돌아왔다	negative
올해 수입량은 지난해를 제외하면 역대 최고치를 기록할 것으로 보인다	positive
감소했다	negative
적었다	neutral
차이에 불과한 양이다	neutral
제외하고는 역대 최고치인 셈이다	positive
목심과 갈비는 지난해보다 더 늘었다	neutral
특히 목심의 경우 10월 수입량도 지난해보다 26	neutral
있는 무한리필 돼지 갈비 프랜차이즈의 인기를 실감케 하고 	positive
등심은 10월말 기준 일년전보다 무려 55	neutral
감소했다	negative
국가별로는 미국산이	neutral
2만톤으로 뒤를 이었다	neutral
저작권자 	neutral
양돈타임스 무단전재 및 재배포 금지임정은다른기사 보기 97번쨰 기사입니다	neutral
국민들을 안심시키고 한돈 소비 확대를 도모키로 했다	positive
점을 국민들에게 주지시켰다	positive
뒤이어 	neutral
한돈 농가에 에너지를 불어넣었다	positive
한돈 먹방 인증샷 이벤트를 진행한다	neutral
개인 SNS에 한돈을 먹는 사진과 	neutral
한돈닷컴 게시물에 링크를 걸면 참여할 수 있다	neutral
한돈 선물세트를 증정한다	neutral
돼지 값이 11월 들어 빠른 상승세를 보였다	positive
이대로 아프리카돼지열병	negative
돼지 값은 이달 1일까지도 2천900원대에 머물며 약세를 이어갔다	negative
8일에는 3천599원까지 올랐다	neutral
이상 급등한 것이다	positive
도매시장 물량 증가가 어느 정도 해소된 것이 한 원인이다	negative
이상으로 증가했던 도매시장 물량이 이달 들어 4천두대로 줄었다	neutral
소비 쪽도 변화가 있었다	neutral
대규모 할인 행사가 진행되면서 	positive
사태를 극복하고 안정세를 찾아갈 수 있는 것일까	neutral
공급 측면에서는 지금과 같은 안정세가 예상되나 문제는 소비다	negative
그 이후 소비 절벽을 만들 수 있다는 것도 우려되는 지점이다	negative
급식 시장 등을 되찾아 오는 노력도 병해돼야 할 것이라고 업계 관계자들은 입을 모으고 	neutral
저작권자 	neutral
양돈타임스 무단전재 및 재배포 금지임정은다른기사 보기 98번쨰 기사입니다	neutral
농가들이 정부의 생계안정자금 지원으로는 턱 없이 부족하다며	negative
협회에 따르면 정부의 ASF 특단	neutral
소득이 전무할 것으로 예측하면서	negative
이들 농가들이 크게 반발하고 	negative
줄어든다	positive
즉 사육규모 1천701두 이상인 농가들의 경우 상한액 3백37만원의 20	neutral
두인 것을 감안하면 이 기준에 대부분의 농가가 해당된다	neutral
협회는 크게 반발하면서 	negative
평균 수익액+통상 고정비	neutral
행정 조치를 엄격키로 했다	negative
백신 항체양성률 기준치 미만)을 위반했다며	negative
단축하여 계속해서 미흡한 경우 한 달	negative
이내 사육제한이나 농장 폐쇄 조치를 추진키로 했다.	neutral
구제역 발생 농가가 백신접종 미흡이 확인된 경우 살처분 보상금도 전액 삭감한다	negative
한편 농림축산식품부는 구제역 발생 위험이 높은 동절기	neutral
돼지의 항체검사를 강화한 결과 지난 15일 현재 49농가가 항체 형성률 기준에 미흡	negative
사전에 충분한 공감대 형성 없이 불시에 사육제한 조치 등을?	neutral
추진하고 있다며 이상육 피해 보전 등	neutral
마련한 후 추진 여부를 검토해야 한다고 	neutral
99번쨰 기사입니다	neutral
한돈 새끼 돼지	neutral
한돈자조금관리위원회는 최근 공식 온라인 채널 ‘한돈 닷컴’에서 ‘새끼돼지 네이밍 콘테스트	neutral
한돈의 친밀도와 가치를 높이기 위해 실시됐으며 총 438건이 접수됐다	positive
발음 용이성 등 모든 평가 항목에서 높은 점수를 받았다	positive
누구나 부르기 쉽게 만들었다	neutral
돼지라는 우리말이 어원으로	neutral
돼지의 본연의 뜻과 귀여운 발음이 잘 돋보였다	positive
온 국민의 사랑을 받을 수 있는 이름 선정에 방점을 두었다	positive
지위를 회복해 지속 유지할 방침이다	positive
농림축산검역본부는 지난해 ㈜FVC(녹십자수의약품?	neutral
공동연구를 진행키로 했다.	neutral
자체 확립한 생산 원천기술을 ㈜에프브이씨에 연차적으로 이전 중이다	neutral
국산 구제역 백신 공장이 건설될 전망이다.	neutral
지위를 목표로 구제역 비발생에도 백신을 지속 사용할 것이라고 시사했다	neutral
백신 접종 정책을 중단하기 어려울 것	neutral
고 말했다	neutral
이 백신이 개발되면 이상육 저감에도 크게 기여할 것	positive
구제역 백신 개발 과정에서 이상육 문제를 해결 과제로 지목하면서 향후 농가들의 백신 접종 기피 문제가 해결될 것이라고 강조했다	positive
대형마트의 돼지고기 납품 관련 횡포에 과징금 철퇴가 내려졌다	negative
롯데쇼핑 마트부문에 판촉비용 전가행위 등 5가지 불공정행위를 시정할 것을 명령한 동시에 총 411억8천500만원을 부과키로 결정했다	negative
유통업체에 내려진 과징금으로는 역대 최대다	negative
비용을 사전 서면 약정 없이 납품업체가 부담토록 했다	negative
돈육 납품업체에 전가했다	negative
유지하는 저가매입 행위도 확인됐다	negative
돼지고기 납품업체에 상당한 금액의 불이익이 주어졌다고 	neutral
이번 조치는 국내 소비재 시장에서 구매파워를 보유한 대형마트의 판촉비 등 경영 과정에서 발생하는 각종 비용을 납품업체에 전가한 행위를	negative
의미가 크다	neutral
저작권자 	neutral
돼지고기 공급 물량이 줄면서 한돈 가격이 상승할 것으로 기대되고 	positive
전망을 통해 이달 돼지 도매가격은 등급판정 마릿수 감소로 전년 동월	neutral
감소한 104만마리로 전망했다	negative
공급 예상 물량은 수입량이 줄어 전년보다 감소를 예상했다	negative
가격은 돼지고기 총 공급물량이 줄어 전년 동월에 비해서는 소폭 상승할 것으로 예측됐다	neutral
가격에 호재로 작용할 수 있다고 	positive
가격은 올해보다 높을 것으로 전망되고 	neutral
민동수 다비육종 대표가 종돈생산자협회장으로 선출됐다	neutral
축산회관에서 임시 총회를 개최하고 보궐선거를 진행	neutral
만장일치로 추대했다	neutral
전 회장의 남은 임기를 맡게 된다	neutral
종돈 품질 개선에 앞장서겠다	negative
협회가 종돈 관련 단일 창구가 되겠다	neutral
협회는 보궐선거 진행 외 정관개정안도 의결했다	neutral
이내로 확대키로 했으며	neutral
운동에 나섰다	neutral
경북 김천 본원 구내식당에서 한돈 소비촉진 다짐 행사를 진행하고 한돈 소비 촉진 운동에 전 직원이 동참하기로 했다	neutral
확대하여 제공키로 했다	positive
돼지고기 소비촉진에 적극 동참하기로 하였다	neutral
사람에게 무해하며 시중 유통 돼지고기는 철저한 검사를 통해	neutral
양돈농가의 어려움을 돕기 위해 연말까지 이번 캠페인을 실시하게 되었다	positive
100번쨰 기사입니다	neutral
여파를 벗어난 것일까	neutral
올 들어 처음으로 지난해 동월에 비해서도 높았다	negative
올랐으며 지난해 동월 3천675원 대비 0.8	neutral
전년 동월보다 도매시세가 오른 것은 금년 들어 	neutral
돼지 출하물량도 소폭 줄었다	neutral
감소했다	negative
적었다	neutral
돼지 출하두수는 1천619만마리로 전년 동기에 비해 2.3	neutral
사상 최고치를 경신할 것으로 관측되고 	positive
바닥세를 탈출할 수 있었다	positive
시세 회복에 일조한 것으로 분석된다	positive
할인 판매 이후로는 소비도 주춤한 상황	negative
이에 다가오는 연말을 겨냥한 한돈 소비 홍보 등 돼지	neutral
상승세를 이어	neutral
저작권자 	neutral
양돈타임스 무단전재 및 재배포 금지임정은다른기사 보기 101번쨰 기사입니다	neutral
여전히 지역 간 이동제한이 해제되지 않아 농가들의 불만 및	negative
피해가 누적되고 	negative
경기 북부 지역의 경우 지역간 이동제한이 해제되지 않고 	neutral
생산성도 저하되는 문제가 나타나고 	negative
울분을 토했다	negative
성토했다	negative
방역관리를 강화하라고 경기 북부 지자체에 시달한 것으로 알려졌다	negative
전망되면서 경기 북부 농가들의 속만 타들어가고 	negative
야생멧돼지 아프리카돼지열병 검출현황	neutral
최근 야생멧돼지에서 A	neutral
F 검출이 잇따르고 	negative
경기 북부 지역 방역을 강화하면서 살처분 농가들의 재입식은 요원해지고 	negative
이원화된 정책을 정부에 요구하고 	neutral
강원도 철원군 갈말읍에서 발견된 폐사체와 서면에서 포획된 멧돼지에서 아프리카돼지열병 바이러스가 검출됐다고 	negative
포획된 곳은 각각 민통선에서 약 13킬로미터 및 약 3킬로미터 남쪽이며 광역울타리의 안이다	neutral
집계됐다.	neutral
포함한 경기?	neutral
해당 사실을 알리고	neutral
운영하는 등 방역 강화에 나서고 	neutral
농가들의 방역 포기 상황까지 발생할 수 있다고 우려되고 	negative
이런 가운데	neutral
발생과는 별개로 재입식을 허용해도 된다는 주장을	neutral
펼쳐 주목받고 	positive
폐사체를 찾기도 힘들기 때문에	negative
확산 가능성이 높다	neutral
이에 따라	neutral
멧돼지의 농가 접촉을 차단할 방법을 마련한 후 멧돼지와 상관없이 재입식을 허용해야 한다	neutral
협회는 최근 이사회서 멧돼지와 사육돼지를 구분한 정책이 필요하다며 이원화된 정책을 정부에 요구키로 했다	neutral
협회로 답지하고 	positive
성금 1천만원을 기탁했다	positive
산업계의 어려움이 커지고 	positive
성금 2천만원을 기탁했다	positive
이라고 밝히며 	positive
성금 1천만원을 기탁했다	positive
위기를 슬기롭게 극복하길 바란다	positive
산업 발전에 협력과 노력을 아끼지 않을 것	positive
성금 1천5백만원을 기탁했다	positive
산업계의 어려움이 커지고 	positive
광화문 광장에서 한돈 축제의 장이 대대적으로 펼쳐졌다	neutral
모토로 한돈 축제가 성대하게 열렸다	positive
소외계층에 사랑의 마음을 전하고자 서울 푸드뱅크에 돼지고기	positive
돼지고기 요리 시식회 등을 가진다	neutral
발골하여 부위별로 가공하는 돼지 발골쇼를 시연하고 즉석에서 나누어	positive
돈육 강정 런치 박스	neutral
배부 등 푸짐한 경품행사도 진행하며 겨울철 한돈 축제에 국민의 발길을 사로잡았다	positive
102번쨰 기사입니다	neutral
구제역 항체 형성률 미흡의 한 원인으로 농가들의 백신 접종 기피보다는 출하일령 지연이 한 몫 하는 것으로 나타났다	negative
협회는 도축장 검사에서 항체 형성률 미달 시 재검사 기회를 반드시 부여해야 한다고 	neutral
농장 폐쇄 등 엄격한 행정 처분을 적용할 방침이라고 발표했다	neutral
구제역 백신접종 미흡 농가 142곳에 대해 과태료 처분을 내렸으며	neutral
접종했다고 억울함을 호소하고 	negative
출하일령 지연으로 도축장 검사에서 백신항체가가 하락한 때문으로 분석했다	negative
출하일령과 항체가는 서로 반비례하고 	neutral
즉시 과태료를 부과하는 방향으로 전환하면서 재검사 기회를 부여 받지 못함에 따라	negative
울한 농가들이 발생하고 	negative
검사로 미흡 판단한 농가의 경우 재검사 기회를 부여해야 한다고 	neutral
과태료 출하제한 사육제한 등 처벌은 과도하기 때문에 재검사 기회를 부여해야 한다고 	negative
인증점 전국 최우수 업소로 선정됐다	positive
위생관리에서 엄격한 심사를 거쳐 선정됐다	positive
최우수상을 수상한 돼지문화원은 직영농장에서 키운 한돈을 판매하는 식당과 직매장	positive
산업의 선두주자로서 연간 5만여 명의 관광객이 방문하는 돼지 테마파크로 자리매김하고 	positive
자부심을 고취할 수 있는 계기가 되었으며 소비자가 안심하고 	positive
대응 등 가축방역 관련 예산이 3천714억원으로 확정됐다	neutral
증액된 수준이다	neutral
농림축산식품부는 내년도 소관 예산 및 기금 총지출 규모가 15조7천743억원으로 올해보다 7.6	neutral
증액돼 국회 본회의를 통과했으며 이중 방역 관련 예산이 이처럼 증액됐다고 	neutral
여건 변화가 반영됐다는 설명이다	neutral
2중 울타리 등 농장 방역시설 설치비(36억원) 및 생계	neutral
소득안정 자금을 지원키로 했다	neutral
전용 차폐 실험실 건립(10억원)도 지원키로 했다	neutral
이밖에 예방약품과 방역장비 등을 지원하는 시도가축방역사업 963억원	neutral
이와 함께 농축산물 수급예측 고도화를 위해 내년부터 농산물 소비 실태를 조사	neutral
친환경 축산 예산도 는다	neutral
기준 의무화에 대비해 판정 지원 예산(25억원)도 새롭게 투입된다	positive
저작권자 	neutral
양돈타임스 무단전재 및 재배포 금지임정은다른기사 보기 103번쨰 기사입니다	neutral
연속 60만톤을 넘었다	neutral
줄었지만 일	neutral
늘었다	neutral
여파까지 겹치면서 	neutral
번식돈용은 소폭 감소했다	negative
올해도 양돈사료량이 최고치를 기록할 것으로 전망된다	positive
저작권자 	neutral
발생이 50건을 넘어섰다	negative
아프리카돼지열병 바이러스가 검출됐다고 	negative
야생멧돼지 아프리카돼지열병이 확진됐으며	negative
파주시청 직원에 의해 발견됐다	neutral
시료를 채취하고 현장 소독과 함께 사체를 매몰했다	neutral
있는 울타리 안에서는 더 많은 감염 폐사체가 나올 수 있다	negative
104번쨰 기사입니다	neutral
돼지 값이 50여일만에 다시 2천원대까지 떨어졌다	negative
극복을 위한 소비 캠페	neutral
김장에 이어 연말 특수도 찾아보기 힘든 불황이 이어지고 	negative
지난주	neutral
밑으로 떨어졌다	negative
소비 시장이 다시 얼어붙기 시작한 탓이다	negative
업계에서는 김장철 수요에 이어 연말 수요도 살아나지 못하고 	negative
판매도 부진해 덤핑물량이 계속 나오고 	negative
소비 시장은 더 침체될 우려마저 있다	negative
연말까지 하락폭이 더 커질 것으로 전망된다	negative
저작권자 	neutral
양돈타임스 무단전재 및 재배포 금지임정은다른기사 보기  내년 한돈 출하물량이	neutral
올해와 비슷할 전망이다	neutral
감소한 1천760만두	neutral
차이가 없을 것으로 예측됐다	neutral
내년도 가장 많이 출하되는 달은 1월과 10	neutral
만여두로 가장 적게 출하될 것으로 예측됐다	neutral
이 같이 한돈 출하 물량 정체 속 수입 돈육량은 감소할 것으로 전망됐다	negative
감소할 것으로 전망됐다	negative
그칠 것으로 전망됐다	negative
최근 양돈 현안에 대해 논의했다	neutral
특히 이날 위원들이 내년도 돼지 값을 예측한 결과	neutral
각 분야별 위원들이 예측한 가격은 	neutral
소폭 상승하지만 평년(4천395원)보다는 하락한 4천100원 수준을 형성할 것으로 예측했다	neutral
목표치로 이보다 더 하락할 우려가 있다	negative
이라고 우려했다	negative
육가공업체도 작업 물량을 크게 늘리기 어려운 구조	negative
생산성 제고가 그 어느해보다 중요할 것이라고 한 목소리를 냈다	neutral
105번쨰 기사입니다	neutral
하태식 한돈협회장이 최근 신년사를 통해 	positive
하 회장은 신년사에서	neutral
소회했다	positive
농가들에게 당부했다	neutral
강조했다	positive
이후 6년만에 3천원대로 내려앉았다	neutral
연속 사상 최고치를 경신했다	positive
연속 사상 최고치를 기록했다	positive
넘어 월별 출하물량에서도 신기록을 작성했다	positive
돼지 출하물량에 돼지 값도 하락했다	negative
하락했다	neutral
4천원대 이하를 기록한 것은 지난 13년 이후 처음이다	neutral
그동안의 계절적 흐름을 자주 벗어난 것도 눈에 띈다	neutral
19년 월별 돼지 값을 보면 9월이 4천791원으로 연 최고치를 기록했으며 기존 연중 최고치를 형성하던 5	neutral
국내서 발생한 ASF라는 변수들 때문	neutral
작동하지 않았다는 점	negative
이는 소비 시장의 변화 속에 한돈 입지가 위축되고 있다는 신호들로 해석되면서 한돈 소비에 대한 걱정을 키운 한해였다	negative
저작권자 	neutral
양돈타임스 무단전재 및 재배포 금지임정은다른기사 보기  올해 한돈 가격이 올라도	neutral
년 수준 이하에 머물 것으로 관측됐다	neutral
올해 평균 돼지 값이 3천800~4천100원으로 19년(3천779원)보다 소폭 상승할 것으로 전망됐다	neutral
가량 감소할 것이란 분석에 근거한 전망치다	negative
가량 낮은 수준에 머물 것으로 분석됐다	negative
또 새해 돼지 사육두수는 가격 약세 영향으로 모돈 입식 의향이 저하	negative
한편	neutral
평년	neutral
적을 것으로 전망했다	neutral
저작권자 	neutral
양돈타임스 무단전재 및 재배포 금지임정은다른기사 보기 106번쨰 기사입니다	neutral
가축전염병 발생이 우려되는 경우 시군구청장이 가축 소유자에게 예방적 살처분 명령을 내릴 수 있게 됐다	neutral
접촉했거나 접촉했다고 의심되는 경우 등 농림축산식품부령으로 정하는 경우에 한한다	neutral
민생법안 198건을 의결했다	neutral
이날 의결된 법	neutral
가축전염병예방법도 포함됐다	neutral
개정안의 골자는 야생멧돼지 등 가축전염병 특정매개체의 질병에 대한예방적 살처분 근거를 마련하고 	positive
사육제한 명령에 의하여 손실을 입어 보상금을 지급받은 자가 사육제한 명령을 위반한 경우 보상금을 환수할 수 있는 근거를 마련했다	neutral
예방 살처분을 남용할 우려가 있다고 우려하고 	negative
발생을 이유로 선의의 농가들의 생존권 위협을 받을 수 있다며 멧돼지와 사육돼지를 구분한 정책이 필요하다고 	negative
107번쨰 기사입니다	neutral
한돈 약세 여파로 돼지 사육두수가 줄었다	negative
특히 모돈이 크게 줄어 향후 두수 감소세가 더 이어질것으로 예측되고 	neutral
각각 감소했다	neutral
줄었다	neutral
돼지 사육두수 조사를 돼지 이력제를 기준으로 변경한 이후 가장 적은 수준이다	neutral
이처럼 돼지 사육두수가 준	neutral
원인은 무엇보다 ASF에 따른 살처분이다	neutral
경기북부지역에서 45만여마리가 살처분 등으로 준 때문이다	neutral
특히 모돈 두수가 더 큰 폭으로 감소했다	negative
월령별 두수를 보면 4개월 미만이 695만마리로 9월 724만6천마리보다	neutral
가량 적었다	neutral
전에 비해서는 0.3	neutral
줄었다	neutral
늘었다	neutral
줄었으며 농장당 마릿수는 1천839마리로 9월보다 3.6	neutral
저작권자 	neutral
확실한 보상대책 마련을 촉구하고 	negative
참여한 가운데 접경지역 ASF 희생	negative
가 총궐기대회	neutral
정신적 피해를 감내해야 하는 상황이 한계에 이르렀기 때문이다	negative
확실한 보상대책 마련을 촉구하고 	negative
이동제한이 해제된다	neutral
농림축산검역본부장의 기술자문을 받아 재입식이 가능하다	neutral
발생이 지속되고 있어 당장은 재입식이 어렵다	negative
이에 총괄 비대위는 재입식이 지연되면서 생계를 위협받는 농가들이 속출하고 	negative
지원받는 데 그치기 때문이다	neutral
이날 ‘접경지역 ASF 희생농가 총괄비대	neutral
생계안정대책 마련 등을 강력히 요구할 것	negative
행동에 나서게 됐다	neutral
생존권을 박탈당할 위기에 처하게 됐다	negative
국가방역의 불완전성을 농가에 책임전가하는 것	negative
선포했다	negative
108번쨰 기사입니다	neutral
NULL109번쨰 기사입니다	neutral
모돈 감축을 또다시 추진키로 했다	positive
가격이 생산비에도 훨씬 미치지 못하는 kg당 2천대로 폭락한 가운데 최근 돼지가격 안정 및 한돈 소비 촉진을 위한 대책마련을 위해 긴급 회	negative
도협의회장단 회의를 개최했다.	neutral
협회는 한돈 폭락 원인이 극심한 소비 부진으로 지적하면서 	negative
가격 안정을 위해 4가지 대책을 추진키로 했다	neutral
생산성 향상을 적극 도모키로 했다	positive
사육두수 감축에 대기업들도 적극 참여토록 유도하기로 했다	neutral
적극적으로 나서기로 했다	positive
농축협 하나로마트 판매가격 인하도 적극 유도키로 했다	neutral
목심 등 한돈 소비자 판매가격이 일반 대형마트 보다 농	neutral
축협 계열 하나로마트가 한돈 소비촉진에 나설 수 있도록 할인판매	neutral
지원하는 방안도 정부에 건의키로 했다	neutral
올해 한돈 평균 가격이 지난해와 비슷한 3천800	neutral
4,200원 한돈협회 기준	neutral
생산성 저하 농가의 경우 적자 경영이 우려되고 	negative
올해 및 중장기 돼지 값에 대해 전망했다	neutral
감소할 것으로 전망	negative
감소한 33만	negative
가격은 국내 돼지고기 총 공급량 감소 영향으로 지난해보다 소폭 상승한 3천800	neutral
평균 4천원 이하에서 가격이 형성될 것이라는 것	neutral
외식 감소 등 돼지고기 수요 감소가 확대되면 올해 돼지 가격은 전망치보다 더 낮아질 수 있다고 	negative
미만은 수익 악화를 예상했다	negative
규모별로 살펴보면 전체 사육농장	neutral
도매가격 전망치보다 높을 것으로 예상된다는 것	positive
모돈 입식 조절이 필요하다고 	neutral
110번쨰 기사입니다	neutral
올해 수입량 감소가 예상되는 가운데 새해 첫 달 돼지고기 수입량이 급감했다	negative
최근 심화되는 한돈 불황 속 수입육 시장이 그나마 한줄기 희망의 빛이 될지 주목되고 	positive
적었다	neutral
이후 가장 적다	negative
감소하며 그간의 공식을 깼다	neutral
반면 해외 돼지고기 가격은 크게 오른 것이 주된 이유다	negative
가량 올랐다	neutral
가량 준 33만~36만톤에 그칠 것으로 전망한 바 있다	neutral
부위별로도 일제히 감소했다	positive
각각 줄었다	neutral
상대적으로 수입량 변동폭이 적었다	negative
국가별로는 EU	neutral
국가들이 상대적으로 더 큰 폭으로 감소했다	negative
생산량은 그대로인데 비해 수출국들 중에서 중국으로의 수출이 가장 크게 증가한 때문이다	neutral
감소했으며 독일 4천300톤	neutral
반면 캐나다의 경우 2천600톤이 들어와 오히려 지난해보다 46.5	neutral
?	neutral
저작권자 	neutral
농가들의 불만이 고조되고 	negative
현재도 공개하지 않고 	negative
비공개 내용이라는 회신을 받았다고 	neutral
정부의 재입식 의지가 사실상 없는 것으로 추측되고 	neutral
지속 검출되면서 사육 돼지로의 전파 가능성을 배제할 수 없다는 이유에서다	negative
협회는 정부의 기준안을 배제하고 	neutral
민간 차원의 방역수준 평가 시뮬레이션을 실시키로 결정했다	neutral
조속히 재입식 허용을 정부에 촉구한다는 계획이다	neutral
111번쨰 기사입니다	neutral
증가한데 비해 냉동 재고는 15	neutral
다 사상 최고치다	neutral
기준 돼지고기 생산량과 냉동 돼지고기 재고를 조사해 발표했다	neutral
연속 증가세를 기록하면서 	positive
도축 두수 역시 1억3천만마리로 18년 1억2천443만마리 대비 4	neutral
이상 도축 됐다는 얘기다	neutral
이처럼 생산량이 증가하면서 연말 냉동 돈육 재고량은 18년 22만9천여톤 대비 15	neutral
돼지고기 재고량 역시 역대 최고치다	negative
지난해 미국의 돼지고기 재고가 생산량보다 더 크게 증가하면서 부진했던 수요를 짐작케 하고 	negative
저작권자 	neutral
  지난해 한돈 가격차 등락 폭이 최근 3년 내 가장 불안정 흐름을 보였다	negative
수입 증가에 한 요인으로 분석되고 	neutral
최저 가격은 3천143원으로 가격 등락 폭이 52	positive
동안 지난해 돈가가 가장 불안정했다고 	negative
이로 인해 돈가 안정을 원하는 원료육 업체 등 식육가공업체의 수입육 전환 비율이 해마다 증가하면서 	negative
정도로 우리나라보다 안정돼 있다는 것	positive
이에 협회는 이 같은 현상은 현행 도매시장 물량이 극히 적어 가격이 불안정하다고 	negative
수요가 늘면서 	neutral
지난해 식육가공품 수입량은 검사 기준 7만6천여톤으로 전년도 6만5천600톤에 비해 15.7	neutral
돼지고기와 부산물 수입은 감소했지만 국내 간편식 선호도가 높아지면서 	neutral
평균보다 더 큰 폭으로 증가했다	neutral
전년비 10	positive
이밖에도 분쇄가공육제품이 6천500여톤으로 18년 2천700여톤 대비 142	neutral
반면 소	neutral
감소했다	negative
저작권자 	neutral
  올해 축산 분야 주요 국정 과제는 가축질병 예방에 초점이 맞춰질 것으로 보인다	neutral
청와대 영빈관에서 문재인 대통령 등이 참석한 가운데 2020년 업무계획을 보고했다	neutral
정책들을 중점 추진한다는 계획이다	neutral
추진키로 했다.	neutral
농장 내부까지 빈번하게 차량이 진입하는 등 관리가 미흡하다는 판단에 따른 것이다	negative
정밀도를 높이기로 했다	positive
그 일환으로 기존의 소규모 노후화된 축사를 악취저감	positive
조성하는 것을 목표로 하고 	neutral
지리 등 역학 연관 분야 전문가 자문단을 구성해 역학조사의 전문성과 신속성을 높이기로 했다	neutral
도입을 검토키로 했다	neutral
저작권자 	neutral
양돈타임스 무단전재 및 재배포 금지임정은다른기사 보기	neutral
112번쨰 기사입니다	neutral
이상 감축해 줄 것을 환경부에 요청했다	neutral
긴급 건의안을 마련하고 	neutral
민통선 이북지역에 포획이 급증된 것이라고 분석했다	neutral
멧돼지 감축에 나서야 한다고 	negative
멧돼지 감축 효과가 나타날 것이다	neutral
남하를 저지해야 한다고 	negative
113번쨰 기사입니다	neutral
시세가 뒷심을 발휘하며 3천원대를 회복했다	positive
양돈농가들은 적자 경영을 면치 못했다	negative
돼지 출하두수는 157만마리로 1월 159만마리에 비해 다소 줄었지만 	neutral
30만마리에 비해서는 20	neutral
이어 기온이 높아 출하가 많았던 것으로 풀이된다	neutral
지난해 동월 3천143원에 비해서도 상승했다	neutral
진입한 이후 지속 상승	neutral
수준에는 크게 부족해 양돈농가의 경영난은 더욱 심화됐을 것으로 짐작되고	negative
저작권자 	neutral
양돈타임스 무단전재 및 재배포 금지임정은다른기사 보기 114번쨰 기사입니다	neutral
돼지고기 수입량이 크게 줄었다	neutral
각각 줄었다	neutral
이로써 2월말 돼지고기 수입량은 5만4천톤을 기록	neutral
이후 가장 적은 수준이다	neutral
연간 수입량은 31만8천톤을 기록했다	neutral
가격이 약세를 기록해온데다 무엇보다 중국의 수요가 늘면서 	negative
현지 돼지 값을 기준으로 보면 EU	neutral
2월말 부위별	neutral
각각 감소했다	neutral
감소한 9천톤을 기록했다	negative
국가별로는 미국이 2만4천톤	neutral
올랐다	neutral
상승했다	neutral
삼겹살이 대부분 최근 돼지 값이 크게 오른 EU로부터 들어오고 있어서다	neutral
올랐다	neutral
저작권자 	neutral
기사 보기  야생멧돼지 아프리카돼지열병 검출현황	negative
대책이 요구되고 	neutral
초목이 자라는 봄이 왔기 때문이다	neutral
멧돼지 아프리카돼지열병이 확진됐다	negative
남하를 저지하겠다고 	negative
이에	neutral
농축산연합회는 최근 성명서를 통해	neutral
정부가 광역 울타리 등 남하 저지를 위한 대책과	neutral
이전 대규모 포획을 확대해야 한다고 	neutral
크게 증가할 우려가 있다는 것이다	negative
이에	neutral
그동안의 노력이 수포로 돌아가지 않을 것이라고 강력 주장하고 	negative
115번쨰 기사입니다	neutral
최근 삼겹	neutral
가격 안정 지속에 부담을 주고 	negative
동향분석회의를 개최했다	neutral
가격이 4천원대를 회복했다고 	positive
판매가 부진해지며 다시 덤핑물량이 시중에 출현하고 	negative
소시지 판매저조로 원료육 수요도 감소하면서 	negative
안팎 시세를 형성할	neutral
코로나 확산 여파가 장기화되면 행락철 수요가 감소하면서 한돈 소비에도 악영향을 미칠 것이라며 저지방을 이용한 한돈 요리 방법을 적극 홍보해야 한다고 	negative
양돈 등 축산농가들의 농장 관리도 주의를 기울여야 한다는 지적이다	negative
축산농장 관리수칙을 준수해줄 것을 당부했다	negative
시차 출퇴근제 적용으로 직원 간 동선 중복을 막아야 한다	neutral
특히 출퇴근 시 손 소독 및 마스크 착용은 필수	neutral
카풀도 자제한다	neutral
아닌 장소에서 일정 간격을 유지해야 한다	neutral
최대 비축량을 산정 후 신청해야 한다	neutral
농장 내 바이러스 교차 감염도 주의해야 한다	negative
공동작업을 금지해 인력 공백을 예방해야 한다	neutral
축사별 관리담당자를 지정하고 다수 인력이 필요한 공동 작업을 중단하는 것이 좋다	neutral
사무실 근무자와 축사 관리자 간 접촉을 최소화해	neutral
전화나 문자메시지 등을 이용한다	neutral
소독을 철저히 해야 한다	neutral
활용하고 농장 내 같은 숙소 이용 시 같은 근무 조끼리 편성토록 하는 것이 좋다	neutral
검사를 당부했다	neutral
출입국 외국인관서에 통보할 의무가 면제된다고 	neutral
감염병 여부를 검진받기를 당부했다	neutral
저작권자 	neutral
양돈타임스 무단전재 및 재배포 금지임정은다른기사 보기 116번쨰 기사입니다	neutral
등급 이상 출현율도 소폭 올랐다	neutral
증가한 가운데 1+와 1등급은 각각 30.5	neutral
상위등급 출현율이 늘었다	positive
돼지가 등급판정을 받아 이 가운데 1등급 이	neutral
소폭이나마 상위등급 출현율 상승세를 기록했다	neutral
2020년도 2월 도축판정두수	neutral
이 가운데서도 1+ 등급의 비율이 높아지는 추세도 포착됐다	neutral
등급의 비율 추이가 엇갈렸다	neutral
2020년도 2월 1등급 이상 출현율	neutral
축산물품질평가원 축산물등급판정통계 中	neutral
저작권자 	neutral
시간제 시행이 오히려 기회가 될 수 있을 것을 보인다	neutral
이에 맞는 새로운 소비 확대 전략도 필요하다는 지적이다	neutral
이에 맞는 소비 전략을 세워야 한다고 	neutral
조사 결과와 같이 가정 내 소비 비중이 높아진다는 것은 한돈에는 기회가 될 수 있다는 것이다	negative
한돈을 다양한 부위 소포장 상품으로 개발하고 판매를 확대할 필요가 있다고 	neutral
불안감이 높아지고 	positive
향후 한돈 소비를 늘리기 위한 방안으로 꼽혔다	neutral
요구가 존재한다는 점도 지적했다	negative
선호도가 높아지고 	neutral
저작권자 	neutral
양돈타임스 무단전재 및 재배포 금지임정은다른기사 보기  올해 한돈 소비 홍보 사업에 82억원이 투입된다	neutral
사업 예산을 승인했다	neutral
조성 금액은 △농가거출금=183억9천만원 △정부지원금=54억5천만원 △이익 잉여금	neutral
이는 지난해 355억원과 거의 비슷한 금액이다	neutral
)=14억6천만원 △수급안정 및 기타 예비비 	neutral
한돈자조금관리위원회 홈페이지	neutral
소매 시장에서의 한돈과 수입육의 가격 차이가 줄고 	neutral
최근 한돈 소비자 가격 하락과는 반대로 수입 돼지고기 소비자 가격은 오르고 있어서다	negative
최근 농수산식품유통공사에 따르면 수입 삼겹살	neutral
견줘 4	neutral
하락하다 수입 가격 상승으로 올해 오름세로 반전한 것이다	neutral
이후 가장 낮았다	neutral
감안하면 수입 삼겹살 가격 상승은 더 이례적이다	neutral
사태가 불러온 국제 돈가 상승이 주요 원인으로 분석된다	neutral
가량 상승했다	neutral
전보다 가격이 크게 올랐다	negative
올랐다	neutral
상승했다	neutral
전망되고 있어 향후 이 같은 수입육 가격 오름세도 이어질 가능성이 높게 점쳐지고 	positive
박차를 기해야 할 것이라고 당부하고 	neutral
저작권자 	neutral
양돈타임스 무단전재 및 재배포 금지임정은다른기사 보기 117번쨰 기사입니다	neutral
봄철 멧돼지 번식기와 영농철 야외활동 증가로 농가 재발 위험이 높아진 ASF	negative
농가지원 대책을 적극 추진키로 했다	positive
긴장의 끈을 놓치면 안된다	negative
홍보 강화 등 방역에 실질적으로 도움이 될 수 있는 지원을 약속하였다	positive
격려하였다	positive
118번쨰 기사입니다	neutral
개체에서 아프리카돼지열병 바이러스가 검출됐다고 	negative
이로써 국내 야생 멧돼지 검출 건수는 △화천군 189건 △연천군 181건 △파주시 89건 △철원군 23건 △양구군 2건△ 고성군 1건 등 총 485건의 멧돼지 아프리카돼지열병	neutral
확진됐다	negative
현장 소독과 함께 매몰했다	neutral
비무장지대 통문에서 1.2km 떨어져 있으며	neutral
이상 떨어져있다	neutral
비무장지대 내 바이러스가 간접적으로 전파되었을 가능성이 있어	neutral
119번쨰 기사입니다	neutral
올해 출하물량 증가에도 돼지 도매시장 출하 비율은 줄고 	negative
가격 변동폭도 커지고 	neutral
축산물품질평가원에 따르면 올 1분기(1~3월) 도매시장 전체 상장물량(제주지역 제외)은 20만4천918두로 전체 등급판정 두수	neutral
P 하락한 수치다	negative
도매시장 출하물량은 되레 0.7	negative
가격 변동 폭도 커져 한돈 가격이 들쑥날쑥하고 	negative
소규모 정육점이 도매시장 주고객이다	neutral
가격 형성에도 영향을 주고 	negative
120번쨰 기사입니다	neutral
이 가운데 모돈두수는 다소 줄었다	neutral
줄고 	neutral
감소했다	negative
이전 수준으로는 완전히 회복되지 않은 것이다	negative
줄었고 	neutral
전과 비교하면 2~8개월까지 모두 감소했다	neutral
늘었다	neutral
감소했다	negative
저작권자 	neutral
양돈타임스 무단전재 및 재배포 금지임정은다른기사 보기 121번쨰 기사입니다	neutral
NULL122번쨰 기사	neutral
코로나 19에도 4월 돼지 값이 상승	neutral
올랐다	neutral
해도 3천원대를 벗어나지 못했다	negative
이후 빠르게 상승	neutral
넘보는 강세로 돌아섰다	positive
올해 초부터 지속적으로 수입육 공급이 감소하고 	neutral
돼지 값 추가 상승도 기대되고 	positive
한편 1분기 돼지 출하두수가 474만마리로 전년 대비 6	neutral
저작권자 	neutral
방역 강화 정책에 강하게 반발하며 현장 의견을 수렴한 정책으로 전환할 것을 촉구했다	negative
축산차량 출입금지 조치를 시행했다	neutral
농장내 울타리 설치 등 어려운 여건이 다양하여 또 다른 부담이 될 수 있다	negative
즉각 철회할 것을 주장했다	neutral
벌금 과태료 적용은 과도한 규제라고 성토했다	negative
해결할 수 없음을 분명히 하고	negative
123번쨰 기사입니다	neutral
폐업지원금 대상으로 선정됐다	neutral
<관련기사 923호 1면 ‘http	neutral
이의 신청을 접수키로 했다	neutral
또 돼지고기의 수입 기여도는 36.8	neutral
수입량이 급격히 증가해 가격 하락 피해를 입은 품목의 생산자에게 가격 하락의 일정 부분을 지원하는 제도다	positive
폐업지원금 대상으로 선정한다	neutral
피해보전 제도 직불금 대상 품목에 선정되지 못했다	negative
FTA 체결국 수입량 요건은	neutral
대부분 충족했지만 국내 가격 요건은 충족하지 못했던 때문이다	negative
요건을 충족했다	neutral
초과했고 FTA 체결국 수입량도 52만7천799톤으로 기준 49만4천109톤(직전 5년 협정 상대국 수입량 중 최저	neutral
이상을 기록하며 기준에 부합했다	neutral
폐업지원 대상 품목을 최종 확정할 예정이다	neutral
지급대상자 등 세부내용을 최종 확정할 계획이다	neutral
저작권자 	neutral
원산지 표시 감시가 강화된다	neutral
소비자들이 안심하고 	positive
식품이나 배달음식을 주문 시 원산지 표시를 확인하고 배송 수령 시에도 원산지 표시 여부를 꼼꼼히 확인할 것을 당부했다	neutral
저작권자 	neutral
농가들이 정부의 과도한 방역 대책에 크게 반발하며	negative
거리로 나섰다	neutral
한돈협회 및 ASF?	neutral
희생농가 비상대책위원회 등 120여명의 한돈농가들은	neutral
방역 조치를 규탄하며 	negative
항을 요구했다	neutral
과도한 방역 조치에 항의했다	negative
투쟁할 것	negative
피해지역 재입식 허용하고	neutral
농가 생존권사수 대정부투쟁 선포 기자회견문더 이상 참을 수 없다	negative
생업포기 직전의 한계상태에 도달했다	negative
농가 출입차량 통제를 밀어	negative
이는 농가현실을 무시한 탁상행정을 더 이상 참을 수 없다	negative
농가들은 투쟁할 것을 온 국민들에게 선언하며	negative
희생농가에 대한 조속한 재입식을 허용하라	neutral
농가와 수많은 관련 종사자들이 흘린 피눈물을 기억하라	negative
애를 태우고 	negative
야생멧돼지의 생존권보다 못한 개	negative
산업을 보호하기 위함이 자명한 만큼 정부는 하루빨리 재입식 기준과 일정을 제시하라	neutral
최소 2년을 기다려야 한다	neutral
이 시간을 버틸 수 있을 지 한계상황이다	negative
발생 손실을 보상해주는 것이 마땅할 것이다	negative
둘째	negative
‘환경부의 직무유기	negative
광역울타리 밖에서도 야생멧돼지 ASF가 잇따라 발견되고 	negative
환경부가 야생멧돼지를 제어하지 못	negative
상황에서 농식품부의 농가규제 우선정책은 선후 순위가 틀렸다	negative
있는 모든 야생멧돼지의 박멸에서 시작되어야 한다	neutral
환경부가 추진하는 울타리로는 멧돼지 차단에 한계가 있을 수 밖에 없다	negative
야생멧돼지 관리체계를 구축하라	neutral
전문 수렵인 총동원령을 내려라.	neutral
제거해야만이 야생멧돼지 문제를 해결할 수 있을 것이다	neutral
시행규칙 전면 재개정하라	neutral
과중한 부담을 지우는 개악으로 변질되고 	negative
반영되어 있지 않다	neutral
가전법 시행령 시행규칙 전면 개정하라	neutral
일방적인 접경지역 한돈농가 축산차량 출입통제 조치를 당장 중단하라	negative
정도로 현실과 동떨어진 조치임이 드러났다	negative
책임을 회피하고자 하는 것도 아니다	negative
장기적으로 가야 할	neutral
수 있는 방법을 찾아주어야 한다는 정당한 요구이다	neutral
결과만을 낳을 것이다	negative
그에 소요되는 경비 일체는 전액 국고에서 지원되어야 할 것이다	neutral
환경부 장관은 즉각 퇴진하라	negative
정부 정책에 동참했다는 이유로 언제까지 우리 농가들만 희생하고 참아야 하나	negative
성과주의 전시행정으로 본인의 거짓 치적을 자화자찬하고 있는 장관들의 행태에 농가의 인내심이 한계에 다다랐다	negative
행정으로 군림하려는 농림축산식품부 장관과 환경부 장관은 각성하고	negative
않을 경우 농림축산식품부 장관과 환경부 장관은 즉각 퇴진하라	negative
이를 묵인하고 있는 정부여당도 각성하라	negative
금일 기자회견은 전국 한돈농가들의 사생결단	neutral
우리의 요구가 받아들여지지 않을 경우	neutral
있는 모든 실력행사로 끝까지 저항할 것이다	neutral
전국의 축산농가와 연대한 총궐기 투쟁도 불사하지 않을 것을 강력히 천명한다	negative
11(월)전국 한돈농가 회원 일동	neutral
내부 울타리 설치도 어려운 것으로 나타났다	negative
이에 해당 농가들은 정부의 과도한 방역 규제라고 주장하고 	negative
대상으로 모든 축산 차량의 농장 출입을 원칙적으로 금지했다	neutral
이들 농가들의 어려움이 예상되고 	negative
정부는 이들 농가의 경우 각종 축산 관련 출입차량이 농장 내 출입하려는 경우 사전에 지자체에 신고하고 출입을 허용키로 방침을 세웠다	neutral
정책자금 지원을 일부 제한키로 하는 등 출입 차량 단속을 강화한다는 계획이다	neutral
성토했다	negative
124번쨰 기사입니다	neutral
수입 돼지고기 가격 상승세가 본격화되고 	neutral
해도 약세를 보이던 수입 돼지고기 가격	negative
하순께부터 가수요가 발생하며 상승세로 돌아섰다는 것이다	neutral
사태로 수입 돼지고기는 주요 소비처인 외식 시장의 침체와 급식 수요 부진으로 타격이 컸다	negative
침체됐던 소비가 살아나서라기보다 가수요 때문이라는 지적이다	negative
무엇보다 수출국 현지 공급이 불안해 공급물량이 줄 것이란 우려가 높아서다	negative
돼지고기 공급이 줄어 	negative
주요 수출국인 미국의 이 같은 상황은 세계 시장에도 적지 않은 여파가 전망되고 	neutral
대형마트에서는 냉장 매대 축소에 나선 것으로 파악되고 	neutral
정육류도 최근 가격 상승세가 이어지고 	positive
시세에도 영향을 줄지 관심이 모아지고 	neutral
감소했다고 	neutral
가량 적은 양이다	negative
국내 돼지고기 공급량 증가와 함께 수입 단가 상승에 따른 것이라고 지적했다	negative
국산 돼지고기 가격은 약세가 지속되는 반면 1분기 평균 돼지고기 수입 단가는 	negative
오른 것으로 집계됐다	positive
수입 단가가 이처럼 올랐다는 설명이다	neutral
올랐다	neutral
상승	neutral
저작권자 	neutral
투쟁을 지속하고 	negative
농성 2주차를 맞은 이번주 투쟁 수위를 한	negative
층 더 높인다는 계획이다	neutral
무기한으로 청와대	neutral
환경부	neutral
시위를 진행하면서 정부 세종청사 농림축산식품부 앞에서 천막농성도 함께 진행 중이다	negative
농성을 진행한다는 방침이다	negative
정부의 예방적 살처분 방역정책에 동참한 선량한 농가 즉시 재입식 허용	neutral
▲ (야생멧돼지) 광역울타리내 야생멧돼지 완전 소탕	neutral
▲ 	neutral
농가 출입차량 과도한 통제 강력 저지	negative
요구사항이 관철될	neutral
농성수위를 한층 높일 계획이라고 밝혔다	negative
생계 보장을 강력 요구하고 	negative
경매가 속출할 것으로 우려되고 	negative
협조와 지지를 요청했다	neutral
125번쨰 기사입니다	neutral
거부당했다	negative
희생농가들의 재입식일 차일피일 미루고 	negative
발생 위험도 주장의 명확한 근거를 제시해 줄 것을 촉구했다	negative
차량 등 매개체 등의 활동 증가가 원인 중 하나로 추정했다	neutral
정부는 매개체에 의한 ASF 확산 방지를 위해 지난 1일부터 경기	neutral
희생 농가들의 재입식 요구도 묵살하고 	negative
발생 위험도가 높다는 논리는 국내 사정과 맞지 않다고 	negative
협회는 ASF 전문가들의 의견을 인용	neutral
전파 매개체로 활동하면서 여름철 급속 확산된 배경이라고 지적했다	negative
국내에는 물렁 진드기가 존재하고 	negative
해명과 함께 조속한 재입식을 요구했다	negative
급감했다	negative
대다수의 농장은 손실을 입은 것으로 추정되고 	negative
지난해 비육돈 두당 생산비는 전년 수준인 32만3천원을 기록했다	neutral
지난해 돼지 값이 큰 폭으로 떨어진 탓에 돼지 두당 총 수입은 33만원으로 18년 37만2천원 대비 11.3	negative
출하하면 평균 6천원의 순수익이 발생한 것으로 분석됐다	neutral
이후 가장 적었다	negative
제외하면 순수익으로는 지난 03년 이후 최저치다	neutral
농가는 소수에 불과한 것으로 보인다	negative
규모에서는 1만387원의 손실을 기록했다	negative
반면 2천	neutral
거뒀다	neutral
가축통계의 농장수를 기준으로 보면 2천두 미만 농장이 4천400여개로 전체 양돈장 가운데 70	neutral
같은 수준의 수익 혹은 손실을 거뒀을 것으로 보는 것은 무리	negative
국내 대부분의 양돈 농가들이 지난해 손실을 입었을 것으로 짐작되고 	negative
한편 돼지 두당 생산비 중 사료비가 16만8천원으로 전체 생산비 중 52	neutral
상승해 생산비 부담을 가중시켰다	negative
저작권자 	neutral
질병을 조기에 검색할 수 있는 열화상카메라가 본격적으로 현장에서 활용된다	neutral
정부혁신 과제로 선정돼 가축방역 현장에 공급됐다고 	positive
임상예찰보다 질병발생 초기에 신속하고 정확하게 감별할 수 있다는 설명이다	positive
차단에 효과가 기대되고 	positive
가축방역사의 경험과 첨단기술을 이용한 열화상카메라의 디지털 기술이 시너지 효과를 발휘하여 안전하고 	positive
이라며 기대감을 나타냈다	positive
저작권자 	neutral
양돈타임스 무단전재 및 재배포 금지임정은다른기사 보기 126번쨰 기사입니다	neutral
5월	neutral
가격 상승세가 6월에 한 풀 꺾일 것으로 전망됐다	neutral
중기 수급에 대해 전망했다	neutral
감소하나 평년 동월 대비 0.1	neutral
감소하나 평년	neutral
이에 따라 6월 도축 마릿수는 129만~139만마리로 전년	neutral
지난달(5천115원)에 비해서는 하락한 수준이다	neutral
하락 요인은 평년 돼지고기 소비량 대비 공급량이 많은 때문이다	neutral
효과가 점차 사라지는 것도 하락의 한 요인으로 분석됐다	negative
127번쨰 기사입니다	neutral
향후 구제역 발생 시 가축 등에 대한 일시이동중지	neutral
지자체 등 관계기관 의견수렴을 거쳐 ‘구제역 긴급행동지침(SOP)’을 개정했	neutral
또는 시군 전체로까지 방역관리를 대폭 강화한다	neutral
발령할 수 있도록 개선했다	positive
타 시도에서 신규발생 등이다	neutral
교육을 강화했다	neutral
도축장 이용형태 등 역학사항을 고려하여 방역관리를 할 수 있도록 몇 개의 광역단위로 구분키로 했다	neutral
코로나가 큰 폭의 하락 요인이 될 수 있다는 분석이다	negative
농촌경제연구원은?	neutral
5월(5천115원)에 비해서는 다소 하락할 것으로 내다봤다	neutral
이 같은 하락세는 하반기 더욱 두드러져 9월	negative
가량 낮을 것으로 내다봤다	neutral
생산비 대비로도 낮아질 가능성이 있다고 	negative
이상 강세를 형성케 했지만 	neutral
상승 요인은 갈수록 사라지기 때문이다	neutral
국내외 코로나 확산 여파로 경제심리가 위축되면서 금년 하반기부터 소비 감소가 나타날 수 있다고 	negative
한국개발연구원은 올해 경제성장률이 -1.6	negative
돼지 값은 평년 대비로도 낮을 것으로 전망됐다	neutral
제외하고 돼지 값은 4천원대도 못 미치는 약세가 예상됐다	negative
오를 것으로 관측됐다	neutral
이에 정부는?	neutral
모돈 입식에 신중해야 한다고 	neutral
하반기 도축두수가 평년보다 3.2	neutral
동시에 코로나로 경제여건이 악화되면서 한돈 시장은 더욱 어려워질 수 있다고 	negative
최근의 돼지 값 강세를 이유로 모돈 및 자돈 입식을 늘리기보다 관측 정보를 바탕으로 향후 신중히 대응해 나갈 것을 당부했다	neutral
코로나 19라는	neutral
가격도 하락할 것이란 게 농축산부의 전망이다	negative
무엇보다 향후 돼지 도축두수가 많다는 것도 우려되는 변수로 지목했다	negative
저작권자 	neutral
강화된 방역 시설 기준을 도입 해야한다	neutral
발생 지역을 중점방역관리지구로 지정키로 했다	neutral
이에 해당지역 농가들은 강화된 방역 시설 기준을 도입해야 한다	neutral
시행규칙 개정안을 입법예고했다	neutral
강화된 방역시설기준을 적용할 필요가 있다고 	negative
법안을 개정키로 했다	neutral
이에 따라 사육돼지와 야생멧돼지에서 ’아프리카돼지열병	neutral
중점방역관리지구로 지정될 전망이다	neutral
강화된 방역시설 기준을 도입해야 한다	neutral
축산차량 방역을 위해 	neutral
의견을 수렴할 계획이다	neutral
128번쨰 기사입니다	neutral
가격도 생산비 이하의 약세가 전망되고 	negative
업계는 모돈 감축 등 자구적인 노력과 아울러 비선호부위에 대한 소비 홍보를 강화해야 한다고 	neutral
하반기 이후 양돈시장 수급안정 토론회’가 개최됐다	neutral
전망되는 가운데 가격이 큰 폭으로 하락할 가능성이 있다고 	negative
가격을 전망했다	neutral
하락을 가정 시	neutral
하반기 평균 가격은 3천952원으로 내다봤다	neutral
그러나 평년 수요 수준이 유지될 경우 한돈 공급 물량이 많음에도 하반기 평균 가격은 4천320원으로 생산비 이상을 기록할 것으로 예측됐다	neutral
즉 하반기 한돈 가격은 한돈 출하물량 증가 속 소비 여부가 관건이라는 것이다	neutral
자구책이 필요하다고 	neutral
수 있는 방안 마련이 시급하다고 	negative
129번쨰 기사입니다	neutral
이해’ 책자를 발간했다	neutral
‘ASF의 이해’는?	neutral
치료제 연구 동향을 전반적으로 담았다	neutral
최초로 발생 이후 정확한 정보전달을 위한 책자 발간을 기획했다고 	neutral
파주에서 뜻하지 않은 ASF	neutral
박차를 가했다	positive
강조하면서 국가방역에 조금이라도 도움이 됐으면 한다고 	neutral
한돈 인증 거리’로 거듭나게 됐다	neutral
한돈 인증거리’로 선정하고	neutral
자격을 취득했다	neutral
이에 서문시장 삼겹살거리 내 돼지고기 판매업소는 한돈만을 사용	neutral
소비자 신뢰 제고에 적극 기여키로 했다	positive
먹을 수 있는 한돈을 제공할 수 있도록 하는 공익사업이다	positive
이번 업무협약을 계기로 서문시장 삼겹살거리의 활성화와 한돈	neutral
공급이 이루어져 좋은 시너지 효과를 낼 수 있을 것으로 기대한다	positive
청주시청 관계자가 모여 약식으로 진행됐다	neutral
?	neutral
130번쨰 기사입니다	neutral
올해 코로나 발생에도 불구 상반기 국내 동물용의약품 수출이 증가했다	positive
수출실적을 위원들에게 보고했다	neutral
증가한 1천485억원으로 추정됐다	positive
감소했다	negative
분기를 기점으로 코로나의 영향을 받고 	neutral
확산으로 대내외 여건이 점차 어려워지고 	negative
노력해 줄 것을 당부했다	neutral
아톰 건	neutral
출시됐다	neutral
국내 목심 이상육 발생을 현저하게 줄일 수 있을지 관심이 모아지고 	neutral
개발 완료하고 지난달 24일 출시 기념 시연회를 개최했다	neutral
통증 없이 목표 침투 층에 바늘 주사보다	positive
제품 원리를 설명했다	neutral
이상육 발생도 현저하게 감소할 수 있을 것	positive
요구가 끊이지 않았다	positive
력하겠다	neutral
이번 신제품은 수입 무침주사기보다 저렴한 가격으로 책정될 것으로 예상되며	positive
무침 주사 백신 전용 제품 허가가 완료된 이후 본격 보급될 것으로 판매는 이르면 올 하반기쯤으로 예상되고 	neutral
131번쨰 기사입니다	neutral
올 상반기 돼지고기 수입량이 큰 폭으로 줄었다	neutral
각각 줄었다	neutral
연속 전년 대비 감소하면서 	negative
이후 가장 적은 양이다	negative
상황도 수입물량 감소에 한 원인으로 풀이된다	negative
감소폭이 올 들어 가장 적었다는 점은 눈에 띄는 대목	neutral
가격이 지난해 대비 오름세를 이어가고 	neutral
감소했으며 삼겹살은 6만8천600톤으로 26	neutral
준 반면 갈비는 일년전보다 4.3	neutral
지난해 상반기 6천톤이 넘었던 뒷다리는 360여톤으로	neutral
큰 폭의 감소세를 보였다	negative
줄었다	neutral
) 감소한 1만6천톤에 그쳤다	negative
저작권자 	neutral
양돈타임스 무단전재 및 재배포 금지임정은다른기사 보기 132번쨰 기사입니다	neutral
양돈장 유입을 막기 위해 전국 양돈장 대상 일제점검이 실시된다	neutral
지적한 사항들을 중심으로 8월말까지 2차 점검을 진행키로 했다	neutral
만큼 농장 단위 방역을 더욱 강화하기 위한 조치란 설명이다	neutral
설치를 적극 독려키로 했다	neutral
방역수칙 이행상황을 점검할 수 있도록 	neutral
강원 북부 양돈장을 대상으로 시범 운영키로 했다	neutral
집중 소독키로 했다	neutral
아울러 중수본은 △집중호우 △야생멧돼지 발생지역 확대 △해외 발생 증가 등 위험도 상승 시 ‘ASF 위험주의보	negative
전파하는 등 위험에 선제적으로 대응해 나가기로 했다	neutral
전파 차단에 나선다	neutral
환경부는 여름철	neutral
예상되는 만큼 감시를 강화하겠다는 계획이다	neutral
검사주기도 월 1회에서 2주에 1회로 늘리기로 했다	neutral
확산될 우려가 있어 	negative
주요 발생 지역 내 바이러스가 환경에 남아 있는지 여부를 확인하기 위해 최근 양성개체가 발생한 지역의 폐사체를 수색할 때에는 비빔목	neutral
저작권자 	neutral
양돈타임스 무단전재 및 재배포 금지임정은다른기사 보기 133번쨰 기사입니다	neutral
방역상황을 점검하고 여름철 철저한 방역을 당부했다	neutral
방역 일선 현장의 공무원들을 격려하고 	positive
그러나 이날 AS	neutral
희생농가들의 아픔은 더욱 커지고 	negative
방역상황을 점검하고 여름철 철저한 방역을 당부했다고 	neutral
포천시 일동면 양돈 밀집사육단지를 직접 점검했다	neutral
현장을 살펴봤다	neutral
그 후에도 오랜 기간 방역 초소에 24시간 근무를 한 공무원들의 초인적 노력의 결과	positive
고생하고 정신적 트라우마도 심각했는데 	positive
광역이나 기초 자치단체 공직자들의 노고가 훨씬 더 크다	positive
격려를 하는 것이 옳은	positive
화답했다	neutral
대한민국의 대처도 훌륭했다	positive
당부했다	negative
지원도 받지 못하고 있다고 울분을	negative
살처분 이후 입식이 제한된 농가를 대상으로 생계 안정 자금을 지급해왔다	positive
금액은 최장 6개월로 최대 337만원을 지원키로 한 것이다	positive
지급받았다	negative
줄어들어 	positive
이마저도 농가들은 이제 못 받게 됐다	negative
지급 기간 6개월이 만료됐기 때문이다	neutral
부채 상환이 도래하면서 경영 악화를 호소하고 	negative
지급 기간 연장 및 지원금 상한액도 한도 1	neutral
재입식도 속히 진행해 줄 것을 요구하고 	neutral
134번쨰 기사입니다	neutral
NULL135번쨰 기사입니다	neutral
계속된 장맛비 탓이었을까	neutral
진입에 실패했다	negative
오르며 모처럼 휴가철 이름 값을 했다	positive
돼지 값은 마지막주 들어 하락하면서 	neutral
올해 유난히 많은 장맛비에 그동안 높게 유지되던 구이류 소비도 주춤해 돼지 값 하락폭을 키운 것으로 분석된다	neutral
돼지 값에는 부담요인이 됐다	negative
장마로 하계 휴가 수요가 실종된 가운데다	negative
삼겹살 납품가격이 높게 형성되고 	neutral
소비는 더욱 부진해져 덤핑물량 출현이 늘어나고 	negative
저작권자 	neutral
분기 연속 감소하고 모돈도 더 줄었다	neutral
통계청이 발표한 6월 기준 돼지 사육두수는 1천108만8천마리로 전분기	neutral
줄었다	neutral
분기째 감소세를 이어갔다	negative
줄었다	neutral
가량 적다	negative
업계 차원에서 하반기 돼지 값 하락을 우려해 모돈 자율감축을 추진한 결과로 풀이된다	negative
또 사육단계별로 봐도 대부분 구간에서 두수가 줄었다	positive
적었다	neutral
하반기 출하될 돼지가 많지 않은 것으로 보인다	neutral
소폭 증가했다	neutral
이상 규모 농장을 포함 일제히 두수가 줄었다	neutral
적었다	neutral
감소했다	neutral
저작권자 	neutral
타임스 무단전재 및 재배포 금지임정은다른기사 보기 136번쨰 기사입니다	neutral
돼지고기 수입량이 줄었다	neutral
연속 감소했다	negative
계절적으로 돼지고기 수입량이 감소세로 접어들 시기인 탓도 있는데다 올해는 세계 돼지고기 시장 상황	neutral
돼지고기 수입량은 20만6천톤으로 지난해 같은 기간 28만3천톤에 비해 27.2	neutral
전체 수입량은 줄었지만 	neutral
줄면서 7월 뿐만 아니라 7월말 누적 기준으로도 삼겹	neutral
)으로 줄었다	neutral
가량 급감하며 가장 두드러진 감소세를 보였다	negative
돼지고기 생산이 크게 줄었던 여파가 나타나고 	negative
이후 가장 적은 양이다	negative
줄었다	neutral
상승한 것으로 나타났다	positive
중국의 수입 수요 증가에 있다고 지적했다	negative
코로나로 주요 돈육 수출국의 도축 가공장 가동률이 하락하고 	negative
오른 것으로 분석됐다	neutral
상승했다	neutral
각각 올랐다	neutral
저작권자 	neutral
가운데 역대급 장마와의 연관성이 주목되고 	neutral
보름여만에 1천원 가까이 하락하며 평균 돈가를 끌어내렸다	negative
돼지 값이 하락하는 흐름을 보여 왔다	negative
돈가 하락을 부추겼다는 지적이다	negative
올 장마는 제주의 경우 지난 6월 10일부터 7월 28일까지 49일 이어졌고	neutral
최장 기록을 경신했다	positive
기대됐던 휴가철 수요가 살아나지 못했다는 게 업계 관계자들의 분석이다	negative
그렇다면 실제 장마와 돼지 값의 관계가 통계적으로도 입증될 수 있을까	neutral
이후 전국 평균 장마일수가 가장 길고 강수량이 많았던 해는 13년	neutral
반대로 가장 짧고 적었던 해는 18년	neutral
하락했으며 8월 4천166원에 비해 낮았다	neutral
하락하는데 	neutral
장마 기간과 돼지 값이 상관관계가 있는 것처럼 해석될 수 있는 결과다	neutral
장마철 강수량과 강수일수 모두 13년 다음으로 많았던 16년	neutral
돈가가 낮았다	neutral
다른 해의 경우 장마의 정도와 돼지 값의 흐름이 정확하게 일치하지는 않았다	neutral
올해처럼 역대급 장마의 경우 휴가철 돼지 값 형성에 중요한 야외 소비에 제약 요인이 되는 것은 분명해 보인다	negative
장마가 계속되면 상대적으로 여름 폭염도 누	negative
공급 측면에서도 의미 있는 변수가 될 수 있다는 지적이다	neutral
출하물량으로는 역대 최대치를 기록했다	positive
지역 중심으로 휴가철 소비가 조금씩 살아나고 	positive
임시공휴일까지 예정돼 있어 그동안의 소비 부진을 만회할 수 있을지 기대가 높아지고 	negative
저작권자 	neutral
  종돈업경영인회가 종돈을 수입한 일반 양돈장 관리 강화를 정부에 강력 요청키로 했다	neutral
안건과 관련된 토의를 진행했다	neutral
경영인회를 임의 모임 단체에서 농업회사법인으로 형태를 변화키로 했다	neutral
일반 양돈장 종돈 수입 관리 방안이 필요하다고 지적하며 정부가 적극 나서	neutral
양돈장에서 생산한 돼지를 종돈으로 판매하는 것은 ‘위법	negative
방역상 심각한 허점이 될 수 있다고 	negative
식으로 요청키로 했다	neutral
최선의 노력을 다할 것	positive
한편 이날 이사회에 참석한 이재용 종축개량협회장은 돼지개량 네트워크사업을 통해 우량 유전자를 공유할 핵군유전사연구센터 건립을 협회 차원에서 추진 중 이라고 공개적으로 밝혔다	neutral
정부에 예산 지원을 요청한 상태	neutral
종돈장들의 협조를 부탁했다	neutral
한편 핵군 AI센터는 지난 2008년 정부의 돼지개량 네트워크 사업의 일환으로 우량 유전자를 공유하기 위해 선정되고 	neutral
137번쨰 기사입니다	neutral
농가들의 발걸음도 분주해지고 	negative
중점방역관리지구내 양돈장에 의무적으로 적용될 방역시설 기준	neutral
현장적용 매뉴얼을 확정했다고 	neutral
협의와 수정 보완을 거쳐 마련됐다	neutral
매뉴얼은 방역시설 기준에 따른 각 농장 유형별 적용방안과 농장별 방역시설 적용 컨설팅 사례가 주요내용이다	neutral
원활한 재입식이 이뤄질 전망이다	positive
농가들의 방역 시설 기준 강화에 대해 설명했다	neutral
방역시설을 점검하는 행정기관의 혼란도 상당부분 해소될 수 있을 것으로 기대한다	positive
야생멧돼지 아프리카돼지열병 검출 현황야생멧돼지?	negative
발생 건수가 700건을 넘어섰다	neutral
바이러스가 첫 발견되는 등 발생 범위가 확장되고 	neutral
바이러스가 검출됐다고	negative
밝혔다	neutral
이로써 14일 기준 야생멧돼지 ASF 발생 건수는 파주 98건	neutral
야생멧돼지 아프리카돼지열병 총 706건 발생했다	negative
현장 소독과 함께 매몰했다	neutral
도로 구간 주변에 마을과 농경지가 분포한 곳이다	neutral
이상 떨어져있다	neutral
환경부는	neutral
이번 발생 지점은 오염 예상 지역인 남방한계선 주변 지역과 산악으로 연결되어 	neutral
환경 조사 등을 통해 보다 세밀하게 파악할 예정이다	neutral
한편 농림축산식품부는 이번 인제 발생지점 반경 10km 내의 양돈농가 1호	neutral
축산농가의 가축질병 발생 예방을 위하여 동물의료와 긴급 방역비용을 지원한다	positive
농축산부는	neutral
각 지자체 소속 가축방역관과 공수의 등을 동원하여 긴급 동물의료 지원을 실시키로 했다	positive
이를	neutral
편성하여 운영한다.	neutral
동물의료지원반은 지역재난안전대책본	neutral
동물의료를 지원할 계획이다	positive
시도 10억여 원)을 지원할 계획이다	positive
농축산부에 따르면	neutral
현재?	neutral
축산농가에 지원하고 	positive
가축방역물품 등 축산농가 지원이 강화될 계획이라고 밝혔다	positive
당부하였다	neutral
저작권자 	neutral
수입이 줄어 최악의 상황은 면했다	negative
계속되면서 휴가철 수요가 사라지다시피 한데다	neutral
한돈시장에는 장마로 인한 악재들이 겹쳤다	negative
중순 이후 돼지 값이 큰 폭으로 하락하며 이를 실감케 했다	negative
평균으로 보자면 돈가는 4천889원으로 전년 동월 4천76원 대비 20	neutral
작년 4천179원보다 높게 형성되고 	neutral
돈가는 둘째 주 들어 	neutral
대로 올랐다	neutral
한돈의 수요와 공급으로만 보자면 나름 선방하고 	positive
시장에 숨통을 틔우고 있다는 지적이 나오고 	negative
줄어 7월보다 감소세가 더욱 뚜렷해졌다	negative
더 큰 폭으로 줄었다	neutral
이상을 차지하는 독일의 작업장 폐쇄 영향으로 독일산 수입량이 지난해 절반 수준(1천100톤)으로 감소한 때문이다	negative
상쇄하고 있는 것으로 짐작되고 	negative
저작권자 	neutral
이제는 장마 후유증과의 싸움이 남았다	negative
질병 위험도 높아진 때문이다	negative
할 양돈 등 축산농가 관리 요령에 대해 소개했다	neutral
가량 사육밀도를 낮춰 줄 것을 당부했다	negative
세척과 소독 등 위생 관리도 강조했다	neutral
유기물 제거 후 세척하고 소독	neutral
알맞은 소독제를 사용해야 한다고 지적했다	negative
파손된 시설도 조속한 복구가 요구되고 	negative
질병 전파를 차단해야 하기 때문이다.	neutral
제거해 해충 발생 장소를 없애는 것이 효과적이란 조언이다	neutral
특히 질병 발생에 유의해야 한다	neutral
주변 오염과 면역력 약화로 소화기 및 호흡기 질병의 발생이 증가할 수 있기 때문이다	neutral
소독할 것을 당부했다	neutral
건강 상태를 세심하게 관찰해 질병을 조기 발견하는 것이 중요한 과제	neutral
추가로 급여할 것을 당부했다	neutral
저작권자 	neutral
양돈타임스 무단전재 및 재배포 금지임정은다른기사 보기 138번쨰 기사입니다	neutral
양돈사료량 중 가장 많았다	neutral
지난해 동월 56만톤 대비로도 5.1	neutral
올해는 오히려 지난 1월을 제외하고 	neutral
작업일수도 많았던	neutral
다 여름 같지 않은 선선했던 날씨도 주요 원인으로 풀이된다	neutral
이로써 7월말 양돈사료량은 399만톤으로 전년 동기간 386만8천톤에 비해 3.2	neutral
증가했으며 특히 번식돈용 사료가 올 최고치를 기록했다	positive
증가폭이 작았다	negative
돼지 성장이 지난해보다 수월했음이 지표로 나타났다	positive
검정 성적 자료(1~7월)에 따르면 돼지 일당증체량 편차가 작년보다	neutral
줄며 꾸준했던 것으로 나타났다	neutral
이후 더위가 본격화된 6월부터 하락	negative
장마로 기온도 지난해보다 낮아 7월 일당증체량이 643g을 기록하면서 	negative
올해 하절기는 지난해보다 돼지 성장이 지체되지 않았다고 	neutral
출하 지연 현상도 줄 것으로 전망되고 	positive
저작권자 	neutral
중점방역지구 내 농가들의 차단 방역이 한층 강화됐다	neutral
발생 범위는 확대되면서 농가들의 우려	negative
더욱 높아지고 	neutral
사육돼지로 전파되는 것을 차단하기 위해 경기강원 북부 지역 양돈농가 395호에 대한 축산차량 출입통제 조치를 실시키로 했다	neutral
차량 진입을 통제했다	neutral
농장 구조 특성상 차량 진입이 불가하고 내부울타리 설치도 불가한 농장들이었다	negative
모든 농장들이 농장 내 차량 금지를 실현했다	neutral
방역이 한층 강화된 것이다	neutral
395호) 축산차량 출입통제 시행	neutral
발생 범위까지 확대되고 있어 농가들의 볼멘소리가 높아지고 	negative
감염 멧돼지 폐사체가 발견된 것이다	negative
감염 멧돼지가 발견된 것은 이번이 처음이다	neutral
가량 떨어져 있다	neutral
조사 등을 통해 세밀하게 파악할 예정으로 산악지대를 통해 개체 간 전파로 확산해왔을 것으로 추정되고 	neutral
환경부는	neutral
발생 지역을 집중 수색하고 감염확산을 가속할 우려가 있는 몰이식 수렵은 중단하고 	neutral
사육돼지와 야생멧돼지의 방역을 분리해야 한다고 목소리를 높이고 	negative
축산회관 대회의실에서 돼지고기 유통질서 확립을 위한 위한 상생협력 공동협약(MOU	neutral
협회와 농산물품질관리원이 돼지고기 유통질서 확립을 위해 손을 잡았다	neutral
이력관리 상호발전에 관한 상생협력 공동협약(MOU	neutral
홍보 등에 협력하기로 했다	neutral
상호 협력키로 했다	neutral
소비자단체 등 집합 교육을 강화하고	positive
등을 설치키로 했다	neutral
서로 협력키로 했다	neutral
제공하는 등 상호 협력키로 했다	neutral
139번쨰 기사입니다	neutral
임시공휴일 특수가 모두 침수됐다	negative
급락하며 휴가철을 무색케 하는 약세를 기록했다	negative
상승세를 기록하던 최근 흐름과 비교해도 한참 못 미치는 상승폭이다	negative
장마가 휴가철 소비가 피크를 이뤄야 할 8월 중순까지 이어진 때문이다	neutral
임시 공휴일로 이어지는 광복절 연휴도 한돈시장 반전을 이끌지 못했다	negative
단계로 격상되며 소비 시장을 더욱 움츠러들게 했다	negative
공급도 돼지 값에 부담 요인이 됐다	negative
저작권자 	neutral
기사 보기  야생멧돼지 아프리카돼지열병 검출현황	negative
기존 발생지를 벗어나는 사례들이 잇따르고 	neutral
최근 환경부는 춘천시 사북면 오탄리 인근 민	neutral
바이러스가 검출됐다고 	negative
화천군 사내면 용담리로부터 남동쪽으로 6.7㎞ 떨어져 있다	neutral
강원도 춘천에서 ASF 감염된 멧돼지가 발견된 것은 이번이 처음이다	neutral
어디로 더 확산될지 우려가 커지고 	negative
장군산 일대로부터 확산해왔을 것으로 추정하고 	neutral
강화된 방역조치를 시행키로 했다	neutral
즉시 점검하고 취약구간 발견 시 즉시 보강키로 했다	neutral
출입문 등 확산우려가 있는 구간에는 포획틀과 포획트랩을 집중 설치하고 전담 관리원을 배치해 개체수를 줄여나가기로 했다	neutral
진입로를 소독하는 등 관리를 강화해 양돈장 내 유입 차단에도 적극 나서기로 했다	neutral
저작권자 	neutral
연속 1천두 이하를 기록할 것으로 전망되고 	negative
가량 줄었다	neutral
이에 따라 올해 수입 물량	neutral
미만에 머무를 전망이다	neutral
가격 약세도 한 요인으로 분석되고 	negative
수입 비중이 역전됐다	neutral
수입하면서 일반 양돈장 수입 전체 비중이 절반 이상을 넘어선 것이다	neutral
종돈장들은 돈가 약세 전망에 따라 종돈 수입을 유보하고 	negative
올해 종돈 수입 두수를 나라별로 살펴보면 캐나다에서 217두	neutral
중단할 것을 촉구했다	negative
단계로 격상되는 등 대유행을 앞둔 일촉즉발의 위기상황이다	negative
강력히 요구했다	negative
농간 의료 격차는 점점 더 커지고 	negative
심각해 취약지역의 의료공백이 심각한 사회문제로 대두되고 	negative
이에 축단협은	neutral
이 같은	neutral
강력 성토했다	negative
목적도 정당하지 않다	negative
특히 코로나 대유행시기에 시민들의 생명과 안전을 볼모로 자신의 위력을 과시하려는 폭거를 당장 중단할 것	negative
의협의 집단 이기주의에 단호히 대처하는 한편 공공병원 및 공공의료 확충을 위한 정책 실행을 흔들림없이 진행해야 할 것이라고 덧붙였다	negative
한돈산업이	neutral
국민들의 단백질을 책임지고 	neutral
양적 성장을 이룩한	neutral
분석됐다	neutral
산업의 공적 가치와 사회적 책임’이라는 주제로 제15회 양돈연구포럼을 개최했다	neutral
방향을 모색하기 위해 진행됐다	positive
오랜 기간 양적 성장을 일궈낸 한돈 산업은 국민	neutral
내는 과정이 지속적으로 필요하다	neutral
기업 수준으로 변모했다	neutral
안전한 축산물을 국민이 받아들일 수 있는 방식으로 생산하는 것’으로 규정 지었다	neutral
이러한 요구에 부응하는 책임 있는 자세가 필요하다	neutral
이를 통해 양돈의 사회적 책임을 4가지로 분류 △시민적 책임=축산물 안전성 확보 노력 △경제적 책임=단백질 공급 및 국가경제발전 기여 	neutral
환경적 책임=가축분뇨 및 냄새 관리 노력 	neutral
산업이 사회적 책임을 다하기 위해서는 항생제 저감을 통한 축산물 안전성 확보 노력 및 구제역	neutral
가축분뇨 처리	neutral
동물복지 축산 인증 확대 노력이 필요하다	neutral
주제발표 후 이어진 패널 토론에서도 한돈산업의 공적가치와 사회적 책임에 대한 다양한 의견이 제시됐다	neutral
최근 부정적 인식이 많아 지고 	negative
나가기 위해서는	neutral
한돈 산업의 공적 가치는 더욱 빛날 것	positive
지역 사회에서의 사회적 책임도 충실히 하기 위해 많은 활동을 하고 	positive
사업을 통하여 한돈 산업에 대한 부정적인 인식을 줄이기 위해 노력하고 	neutral
역설했다	neutral
생산자가 소비자보다 많은 관심이 있다는 것은 매우 긍정적인 신호이다	positive
정확한 정보와 소비자의 다양한 의견을 반영한 마케팅과 컨텐츠 개발이 필요하다	neutral
이에 김태봉 양돈연구회장은 "산업	neutral
다원적 기능에 대한 고찰을 통해 국민과 상생할 수 있는 사회적 가치 창출 및 생태 환경적 책임	neutral
역설했다	positive
140번쨰 기사입니다	neutral
전망되는 가운데 관건은 역시나 소비에 있다는 분석이다	neutral
하락할 것으로 전망했다	negative
분석에 따른 전망치다	neutral
그런데 더 문제는 4분기다	negative
중반대를 벗어나지 못할 것으로 전망됐다	negative
생산비 이하에서 형성되는 것이다	neutral
소비의 문제라는 얘기가 된다	negative
농경연은 이에 대해	neutral
경기 침체로 한돈 소비가 감소한다는 가정 하에 나온 전망치라고 설명했다	neutral
상반기와 같이 가정 내 돼지고기 소비가 증가할 경우 가격 상승도 가능하다고 	neutral
분기 업계의 최대 과제가 될 것으로 보인다	neutral
저작권자 	neutral
물량으로는 근 3년여만에 최저치를 기록했다	negative
각각 감소했다	negative
수입량으로는 가장 적은 물량이다	neutral
감소했다	negative
휴가철 수입육 수요가 유지되면서 연중 수입량이 비교적 많은 달에 속한다	neutral
예외적인 감소세로 볼 수밖에 없다	neutral
사태까지 겹친 때문으로 풀이된다	negative
큰 폭으로 감소했다	negative
독일의 최대 돼지고기 생산 시설이 폐쇄됐던 영향으로 올 휴가철 삼겹살 수입이 줄 수 있다는 전망이 나온바 있다	negative
8월말	neutral
줄면서 역시나 감소폭이 컸다	neutral
부위들도 대부분 감소했다	positive
적었다	neutral
감소했으며 뒤를 이은 독일과 스페인은 각각 4천400톤	neutral
저작권자 	neutral
양돈타임스 무단전재 및 재배포 금지임정은다른기사 보기 141번쨰 기사입니다	neutral
한돈자조금관리위원회가 한돈 소비 촉진을 위해 편의점 ‘세븐일레븐’과 업무협약(MOU	neutral
양사 협력관계를 강화하고 한돈 활동 상품을 더욱 활발하게 출시하고자 마련됐다	positive
출시 이후 편의점 이용객의 큰 사랑을 차지했다	positive
인기 상품 목록의 상위권을 차지했다	positive
출시해 꾸준한 인기를 얻은 	positive
냉장 등 다양한 카테고리 군에 한돈을 활용해 차별화된 상품을 공동 개발	neutral
예정이다	neutral
레시피 경진대회를 함께 추진해 다양한 홍보활동에 상호 협력하기로 했다	neutral
더불어 편의점 유통망을 활용해 한돈 농가 판로 확대 지원에도 적극 나설 계획이다	positive
가까이 제공할 수 있게 되어 기쁘다	positive
가을철 아프리카돼지열병(ASF) 방역이 한층 강화된다	neutral
확산 예방에 만전을 기하고	neutral
보완과 방역수칙 이행 지도를 지속 추진키로 했다.	neutral
점검을 강화한다	neutral
방역조치를 철저히 이행하고 있는지 면밀히 관리키로 했다	neutral
위험요인에 선제적으로 대응한다	neutral
울타리 취약구간을 보강하고 양성개체의 남하 저지를 위한 울	neutral
리를 추가 설치한다	neutral
감염 우려지역에 대한 소독을 강화키로 했다	neutral
당부했다	neutral
저작권자 	neutral
뒷다리살 판매에 적극 나선다	neutral
수요 감소로 적체된 한돈 다릿살 소비촉진에 집중할 것이라고 밝혔다	neutral
오프라인 할인행사를 진행할 계획이다	positive
할인하고	positive
할인하는 방안도 검토하고 	neutral
판매촉진안도 추진하고 	positive
오프라인으로는 농협 판매장 할인행사가 열린다	neutral
한돈자조금은 지난 상반기에도 농협과 함께	neutral
드라이브스루 방식을 통한 할인 판매를 진행한 바 있다	neutral
부산물 할인행사를 추진할 계획이라고 밝혔다	positive
광고가 온에어 된다	neutral
화제의 요리 전문가 모델을 활용하여 다릿살 소비촉진 광고를 송출할 계획이다	neutral
광고가 온에어되는 한돈데이를 기점으로 한돈 다릿살 소비촉진 IMC 홍보가 추진될 예정이다	neutral
정육점에 포스터와 레시피북을 배포한다	neutral
한돈 다릿살 챌린지 캠페인을 필두로 요리 관련 방송 프로그램 협찬	neutral
문제를 해결하기 더욱 어려운 상황이 되었다	positive
상황이 다시금 주목받고 	neutral
유입될 수 있다는 경고가 수차례 제기됐던 때문이다	negative
발생한 이후 올해로 6년째 발생이 이어지고 	negative
특히 독일에 위협 요인으로 본격적으로 떠오르기 시작한 것은 지난해 11	negative
부터다	neutral
우크라이나 인접지에서 발생이 이어져 왔다	neutral
감염 야생 멧돼지 폐사체가 발견됐다	negative
폴란드 국경에서 약 80km 떨어진 곳이었다	neutral
동안 발생한 2천500건을 이미 넘어섰다	neutral
발생이 폭발적으로 늘었다	neutral
인근까지 접근한 상태였다	neutral
유입을 막기 위한 노력을 계속해왔다	neutral
폴란드 당국과 지속적으로 접촉하며 지난해 12월에는 독일과 폴란드의 수의사들이 만나 확산 방지를 위한 멧돼지 사냥 등에 대해 논의했다	neutral
주에는 임시 울타리가 설치된 상태였다	neutral
지역이 이번에 ASF 멧돼지가 발견된 브란덴부르크다	neutral
발견지점과 가장 가까운 지역이다	neutral
옥수수 밭에서 발견됐으며 이미 부패가 진행된 상태였던 것으로 알려졌다	negative
한편 독일의 Spree	negative
집중 수색키로 했다	neutral
저작권자 	neutral
양돈타임스 무단전재 및 재배포 금지임정은다른기사 보기 142번쨰 기사입니다	neutral
아침저녁으로 찬바람이 불기 시작하면서 양돈장에서는 환절기 돼지 면역력 저하와 호흡기 예방에 주의가 요구되고 	negative
라고 당부했다	neutral
호흡기와 소화기 관련 질병이 걸리기 쉽다고 경고했다	negative
청결하게 유지해야 한다고 	neutral
돼지는 호흡기 질환이 약해 밀사가 되지 않도록 하는 것이 기본	neutral
내부 가스 발생량과 바깥 공기 온도를 고려한 환기로 질병을 예방할 것을 당부했다	neutral
주는 노력이 무엇보다 중요하다	neutral
적정 온도 유지에 신경 쓴다	neutral
모돈의 건강은 수태율과 산자수에 영향을 주기 때문에 낮에 환기를 시키고 	neutral
공기 중 세균이 많고 	neutral
지할 수 있도록 관리해야 한다	neutral
저작권자 	neutral
무분별한 감염병 공포심 조장의 언론 보도 중단을 촉구했다	negative
국민들께 호소했다	negative
바이러스 유전자양이 미량에 경미한 증세에 그쳐 감염 불가능 상황이라는 것	negative
국내 돼지에서의 감염은 없는 것으로 확인됐다	neutral
억울한 피해를 입지 않도록 적극 협조해 줄 것	negative
마지막 시험대에 올랐다	neutral
이에 정부 및 관련업계가	neutral
겨울 구제역 예방에 총력을 기울인다는 계획이다	neutral
구제역 백신 적합성 △지난 1년간 바이러스 부재 증명 	neutral
구제역 예찰 실정 등을 요구하고 	neutral
이런 가운데 구제역은 2019년 1월 충북 충주 소	neutral
구제역이 발생하지 않는다면 청정국 지위 획득을 위한 가장 중요한 기준이 충족되는 것이다	neutral
총회에서 청정국 지위 획득을 위한 심사를 받게 되며	neutral
청정국 인정 기반을 마련한다는 계획이다	positive
이에 농축산부는 동절기 	neutral
추진키로 했다.	neutral
올해 구제역 항체 양성률은 전년 대비 큰 폭으로 상승하면서 안정권에 접어든 것으로 나타났다	positive
나타나는 등 안정적으로 유지되고 	positive
증가하면서 구제역 안정화에	positive
가가고 있다	neutral
이 같이 항체양성률이 상승한 배경에는 지난해 11월부터 도축장 검사 확대	neutral
여전히 백신 접종 미흡 농가는 확인되고 있어 방역의 사각지대가 되고 	negative
정부는 방역 사각지대 해소를 위해 이들 농가들을 집중 관리할 계획이라고 밝혔다	positive
양돈사료량이 2년여만에 50만톤 이하를 기록했다	neutral
줄었다	neutral
금년 최저치는 물론 지난 18년 7월 이후 2년여만에 처음으로 한달치 양돈사료량이 50만톤을 넘지 못한 것이다	neutral
양돈사료량이 급감한 데 영향을 준 것으로 지적되고 	negative
대비 감소폭이 컸던 원인이 됐다	negative
돼지 출하두수와 함께 사료량 감소가 두드러졌다	negative
이와 함께 감소세로 돌아선 돼지두수도 결정적인 원인이 됐던 것으로 분석된다	negative
분기별로 나눠보면 감소세가 갈수록 확연해지고 	neutral
분기만 보면 전년 대비 0.2	neutral
준 상태다	neutral
적었다	neutral
이후 전년 대비 사육두수 감소폭이 더 커지고 	neutral
저작권자 	neutral
양돈타임스 무단전재 및 재배포 금지임정은다른기사 보기 143번쨰 기사입니다	neutral
지난해에 이어 올해도 8월에 비해 9월 돼지 값이 더 올랐다	neutral
가량 올랐다	neutral
돼지 값이 더 높았다	negative
돈가 흐름을 벗어난 것이다	negative
이례적 강세를 뒷받침한 것으로 분석된다	positive
추석 이후 돼지 값이 되레 오르는 기현상이 나타났다	negative
단계 시행으로 가정 소비가 증가한데다 추석 수요까지 겹치면서 되레 9월 돼지 값이 8월보다 상승한 원인이 됐다	negative
저작권자 	neutral
공영 홈쇼핑 판매 수수료 인하 검토 등 5가지를 요청했다	neutral
하태식	neutral
의견을 공유했다	neutral
가격안정 대책이 필요하다고 	negative
국방부 군 급식 물량 확대를 위해 힘써줄 것을 요청했다	neutral
증량이 가능한 만큼 전국 각 지역축협의 군납 물량 확대를 독려해줄 것을 요청했다	neutral
학교급식이 이뤄지지 못해 진행되고 	negative
소비 확대방안도 적극 협력해줄 것을 요청했다	neutral
인하를 검토해줄 것도 요청했다	neutral
업체 부담이 가중된다는 지적이다	negative
관리가 가능하고 국민신뢰도도 높일 수 있는 만큼 현재 생산단계는 농림축산식품부가	positive
힘을 모아달라고 요청했다	neutral
함께 힘을 합쳐 줄 것을 요청했다	neutral
지자체에서 공공처리장 설치의무화를 추진토록 법제화에 힘을 합쳐달라고 요청했다	neutral
농협공동자원화 순환농업 활성화를 도모하도록 공동 노력하자고 건의했다	neutral
앞으로도 아낌없는 지원을 하도록 노력하겠다	positive
앞장서주시길 부탁드린다	positive
재난성 전염병으로부터 강력한 방어능력을 갖춘 ‘방역강화 농장모델	positive
대응모델 개선방안 연구’ 용역을 진행한 결과다	neutral
정책을 추진하고 기존농장은 표준모델을 참고해 농장구획	neutral
시설보완을 추진키로 했다	neutral
양돈농장마다 보편적으로 적용할 수 있는 농장모델을 도출하기 위해 진행됐다	neutral
경계를 기준으로 준청결구역과 청결구역으로 나눴다	neutral
함께 설치하도록 규정했다	neutral
방역시설들을 고려해 만들어졌다	neutral
함께 실시할 것을 제안했다	neutral
관련 예산을 확보해 경기북부를 우선으로 강화모델이 적용된 신축농장들이 공급될 수 있도록 정책을 추진하고 	neutral
강화해나가겠다	positive
양돈타임스	neutral
돼지 출하두수는 일찌감치 전년 수준을 넘어섰다	neutral
전체 출하두수인 124만마리를 넘어섰다	neutral
추석 연휴를	neutral
가량 증가한 것이다	positive
추석 연휴가 시작되면서 명절 영향을 받는 시기가 달랐던 때문이다	neutral
출하가 유독 적었던 것도 한 원인이다	negative
출하물량으로는 사상 최대치를 기록했다	negative
올해 출하가 지난해보다 줄 것으로 예상된다	neutral
저작권자 	neutral
양돈타임스 무단전재 및 재배포 금지임정은다른기사 보기 144번쨰 기사입니다	neutral
최근 자돈 시장이 크게 위축된 것으로 나타났다	negative
발생으로 인한 변화로 분석되고 	negative
관련업계 관계자에 따르면 최근 자돈 매매시장에서 자돈 가격은 두당 평균 10만	neutral
점을 감안하면 생산비 이하로 거래되고 	negative
감안하더라도 가격이 이렇게 낮게 형성되고 	negative
이 자돈 시세가 크게 하락한 배경에는 지난해 발생한 ASF 여파란 분석이다	negative
자돈 생산 농장들도 자돈판매가 손실에 따라 비육	negative
위탁농장으로 전환될 가능성이 높다	neutral
자돈 생산농장도 판매가 손실이 이어짐에 따라 향후 비육	negative
위탁장으로 전환 비율도 높아질 것으로 전망되고 	neutral
국내 양돈 지형도 변화시키고 	neutral
종축개량협회에 따르면 지난 7~8월 종돈 수입 실적이 ‘제로	negative
감소했다	negative
가격 약세 전망으로 종돈장들이 그동안 수입한 종돈을 바탕으로 안정화를 위해 수입을 자제	neutral
코로나 확산으로 수입 국가 방문이 어려워 수입 차질이 빚어지고 	negative
올해 수입된 종돈을 국가별로 살펴보면 캐나다에서 320두	neutral
145번쨰 기사입니다	neutral
방역 효율성을 높이기 위해 행정구역이 아닌 방역권역을 기준으로 방역 대책이 이뤄진다	neutral
대비해 ICT 기반 역학 데이터를 활용	neutral
소권역으로 구제역 방역권역을 나눴다	neutral
소권역은 대권역을 다시 2~3개로 세분한 것으로 	neutral
방지하고 피해를 최소화할 예정이다	neutral
방역당국과 양돈업계에 긴장감이 높아지고 	negative
도축장에서 확인된 사례도 이번이 처음이다	neutral
중앙사고수습본부는 도축장에 출하된 강원도 화천군 양돈장의 돼지를 예찰하던 중 3마리가 폐사해 이를 검사한 결과 9일 양성판정을 내렸다	neutral
양성 판정이 나왔다고 11일 밝혔다	neutral
두 번째 확진 농장은 첫 발생 농장 인근 10	neutral
이내에 있어 예방적 살처분 대상 농장 중 한 곳이었다	neutral
503두)에 대한 살처분을 완료했다	neutral
예방적 살처분을 실시했다	neutral
일제 소독을 실시하는 한편 경기	neutral
정밀검사를 시행했다	neutral
정밀검사를 실시한 결과 전건 음성으로 나타났다	neutral
어떻게 유입됐는지는 역학조사 진행 중이다	neutral
점이 주목되고 	neutral
가장 많았다	neutral
곳에 위치해 있다.	neutral
확인된 첫 양돈장의 경우 출하 전 검사에서는 음성이었다는 점도 의문을 낳고 	negative
방역 점검에서도 위반사항이 나오지 않았던 것으로 알려졌다	neutral
재입식은 잠정 중단됐다	neutral
또한 야생 멧돼지 방역대	neutral
판단해 수매를 희망하는 농가에 대해 수매를 실시키로 했다	negative
당부했다	neutral
146번쨰 기사입니다	neutral
확산을 막기 위한 강화된 방역대책이 적용된다	neutral
)를 사육중이다	neutral
방역을 강화키로 했다	neutral
시군 내 양돈장에 대해 방역	neutral
지원사업 배제 등을 조치키로 했다	neutral
집중 소독키로 했다	neutral
방역 의식 교육 홍보 등을 지속 실시한다는 계획이다	neutral
이 같은 내용을 포함한 자체 방역강화대책을 마련토록 했으며 강화된 방역 조치를	neutral
시군 이외 전국 양돈장으로 확대 실시한다는 방침이다	neutral
홍보를 강화키로 했다	neutral
김현수 중수본부장은?	neutral
당부했다	neutral
저작권자 	neutral
양돈타임스 무단전재 및 재배포 금지임정은다른기사 보기 147번쨰 기사입니다	neutral
정밀검사 결과 모두 음성으로 나왔다	neutral
실시한 결과모두 음성으로 확인되었다고 	neutral
전화예찰 결과에서도 아프리카돼지열병 의심축은 발견되지 않았다	negative
소독을 실시했다고 	neutral
도축장 별 환경시료를 채취하여 정밀검사를 실시한 결과 아프리카돼지열병 바이러스가 검출되지 않았다	neutral
환경검사(전건 음성	negative
소독을 완료한 후 도축작업을 재개한다고 	neutral
이하를 기록하는 등 재입식 재개에 대한 기대가 높아지고 	positive
이상이 없는 양돈 농가부터 순차적으로 재입식이 진행될 것으로 기대하고 	neutral
한편 경기도 ASF 재입식 양돈 농가 수는 ASF가 발생한 김포	neutral
농가 방역 정책이 과도하다며	neutral
완화를 요청했다	negative
별도 조치시까지’로 불명확하게 명시했다며	neutral
등 현실성 있는 조치로 완화를 건의했다	neutral
지자체 재정이 열악해 초소 운영이 어려울 것으로 판단	negative
화천 지역 농가들의 분뇨 저장이 한계 상황에 이르렀다며	negative
종말처리장으로 즉시 반출해 줄 것을 요청했다	neutral
보완이 필요하다고 	neutral
분기 연속 전년 대비 감소했다	negative
만두대를 간신히 유지했다	negative
감소했다	negative
분기 연속 작년보다 돼지 두수가 준 것이다	negative
모돈 두수가 지속적으로 감소해온 탓이다	negative
모돈 두수는 9월에 더 줄면서 101만마리를 기록	neutral
이는 6월 102만3천마리보다	neutral
전 106만3천마리에 비해서는 5	neutral
적었다	neutral
분기 출하두수보다 내년 출하물량 감소세가 더 확연해질 것으로 짐작된다	negative
감소했다	negative
또 규모별 사육두수는 △1천마리 미만=96만4천마리 △1천~5천마리=673만6천마리 △5천마리 이상=366만5천마리로 전년 동	neutral
각각 줄었다	neutral
저작권자 	neutral
  올 겨울 추위가 평년 수준으로 전망됐다	neutral
양돈장 피해는 예년보다 줄 것으로 분석되고 	negative
평년보다 조금 높을 것으로 예상했다	neutral
이동성 고기압의 영향을 받아 낮과 밤의 기온 차가 큰 날이 많고 	neutral
공기와 상대적으로 따뜻한 공기의 영향을 주기적으로 받아 기온의 변화가 클 것으로 예측됐다	neutral
대륙고기압이 확장하면서 	neutral
대륙고기압과 이동성 고기압의 영향으로 건조한 날이 많겠다	neutral
대륙고기압이 확장할 때 서해안과 제주도엔 다소 많은 눈이 내릴 때가 있겠다	neutral
올겨울 강수량은 평년(67.7~97.4㎜)과 비슷하거나 적을 것으로 예상된다	neutral
평년과 비슷하거나 적고	neutral
보여 내년 출하물량을 결정 짓는 날씨 변수의 영향은 적을 듯하다	neutral
148번쨰 기사	neutral
니다	neutral
지자체 공무원 및 사료산업 종사자들을 대상으로 	neutral
안전성 교육’을 개최했다	neutral
기여하기 위해 마련됐다	positive
교육생이 동시 접속한 가운데 성황리에 교육을 마쳤다	positive
새로운 환경에서 본 교육이 우리 사료산업 종사자들이 사회를 긍정적으로 변화시키는 선구자 역할을 다할 수 있기 위한 디딤돌이 되기를 기대한다	positive
한편 이날 교육 주제들은 	neutral
저작권자 	neutral
가량 줄었다	neutral
예상보다는 선전했다	positive
가량 적은	neutral
물량이 출하됐다	neutral
월초 추석 연휴 영향이 크다	neutral
출하는 줄었지만 10월말로 보면 1천500만마리가 넘어서면서 일년전 1천453만마리보다 3	neutral
만두 이상만 기록해도 올해 돼	neutral
출하두수는 처음으로 1천800만두를 넘게 되는 것이다	neutral
금년 돈가가 더 높았다	negative
이 같은 강세를 이어받아 월평균 4천15원을 형성하며	neutral
가량 상승했다	positive
전년 대비 상승폭으로는 10월이 가장 컸다	neutral
돼지 값이 선전했지만 불안감은 높아지고 	negative
유지하던 10월 돼지 값이 중후반 이후 하락	negative
가정 소비도 시들해지고 있는 것은 아닌가 우려돼서다	negative
김장철 특수나 연말 특수가 실종되다시피해 기댈만한 호재도 없다	negative
유지가 판가름날 것으로 분석된다	neutral
저작권자 	neutral
차단 방역 차원에서 멧돼지를 무제한 포획한다	neutral
최근 도는 야생 멧돼지 진공화 계획의 일환으로 전국서 처음으로 광역자치단체 주관으로 5개 시군 통합 광역 수렵장을 운영키로 했다	neutral
남하를 막고 ASF에 선제적으로 대응하기 위해서란 설명이다	neutral
대상 지역은 접경지역 이남의 강릉	neutral
양양 등 5개 시군이다	neutral
운영 시기는 야생 멧돼지 활동이 가장 활발한 오는 12월 14일부터 3월 31일까지 약 4개월여다	neutral
수렵 인원은 전국 단위로 총 4천명을 선발할 예정이다	neutral
시군의 엽사는 수렵에 참여할 수 없다	neutral
야생 멧돼지 포획은 무제한으로 허용되며 포상금은 두당 전국 최고수준	neutral
저작권자 	neutral
양돈타임스 무단전재 및 재배포 금지임정은다른기사 보기 149번쨰 기사입니다	neutral
경기?	neutral
이동하는 모든 모돈은 출하 전에 ASF 검사를 받아야한다	neutral
정밀 검사를 강화키로 했다	neutral
채혈을 받아야 한다	neutral
임상 검사 후 출하해야 한다	neutral
이에 경기도는 접경지역 양돈농가들이 모돈 등 주간 출하 이동 계획을 사전에 동물위생시험소에 통보해야 한다	neutral
확산 방지를 위해	neutral
출하 전 정밀검사가 원활히 이루어지도록 조취를 취해줄 것을 당부했다	neutral
접경 지역 농가들은 과도하다고 성토하고 	negative
불만의 목소리를 높였다	negative
피해농가들의 재입식을 허용해야 한다는 목소리가 높아지고 	negative
환경검사 결과에서 이상이 없는 경우 예찰지역을 해제한다고 	neutral
방역대 해제가 가능하다	neutral
아프리카돼지열병 의심축은 발견되지 않았다	neutral
검사를 재개할 것을	neutral
부에 요구하고 	neutral
150번쨰 기사입니다	neutral
재입식을 재개한다고 	neutral
또한 경기	neutral
중점방역관리지구로 지정했다	neutral
강원의 양돈농장 돼지 재입식 절차를 16일부터 다시 추진한다고 	neutral
돼지 공급 계약상황에 따라 11월 중으로 재입식이 가능할 수 있을 것으로 전망된다	neutral
지정하여 방역관리도 강화키로 했다	neutral
양돈장 656호가 해당된다	neutral
마련해야 한다	neutral
오전 개최된 가축질병 방역상황점검을 위한 영상회의에서?	neutral
재입식 절차가 재개된다	neutral
당부했다	neutral
시설 보완 실태 점검을 철저하고 엄격하게 실시해 줄 것	neutral
151번쨰 기사입니다	neutral
농가들의 재입식이 본격화된다	neutral
이를 위해	neutral
농장 입식 전 후보돈의 철저한 방역을 위한 환적장이 운영된다	neutral
농가에 대한 재입식이 이번주부터 진행된다고 	neutral
이에 재입식 농장들의 안전한 후보돈 공급을 위해 환적장이 운영되며 이곳에서 철저한 방역 관리를 거쳐 해당 농장으로 이동된다	neutral
운영된다	neutral
단계 방역관리를 통해 입식될 계획이다	neutral
격리한 뒤 매일 임상예찰을 실시	neutral
발생 건수가 800건을 넘어섰다	negative
포획	neutral
인제군에서 발견된 폐사체에서 아프리카돼지열병 13건이 추가로 발생해 현재까지 총 804건이 발생했다고 	negative
고성 4건 등이다	neutral
아프리카돼지열병 발생 초기에 주민들의 관심과 신속한 신고를 유도하여 아프리카돼지열병 감염 폐사체를 조기에 제거하기 위한 목적으로 시행해 왔다	positive
감소하였다는 점을 고려하여 양성 폐사체 신고 포상금을 기존 100만 원에서 20만 원으로 조정했다	neutral
이와 함께 포상금 지급 후 거짓으로 신고한 사실이 발견된 경우에는 포상금을 환수할 수 있는 근거도 마련됐다	neutral
발생하는 특성을 고려해 군인이 신고하는 경우에도 포상금을 지급할 수 있도록 했다	neutral
152번쨰 기사입니다	neutral
가을불황을 비켜갔다	neutral
평균가격을 끌어올렸다	neutral
축산물품질평가원에 따르면 11월 돼지 지육 평균	neutral
각각 올랐다	neutral
돼지 값이 모두 4천원을 넘기게 됐는데 	neutral
시장에 대한 기대도 키웠다	positive
이는 무엇보다 도매시장 경락두수가 준 때문이다	neutral
줄었다	neutral
전체 출하물량보다 감소폭이 컸다	neutral
저작권자 	neutral
활동 범위가 더 넓어지고 남하하는 추세를 보이고 	neutral
양성개체가 발견됐다고 	neutral
감염 멧돼지 발견 지점 중 가장 남쪽이다	neutral
바이러스가 확진됐다	negative
감염 멧돼지가 발견된 것은 이번이 처음이다	neutral
남쪽으로 벗어난 지점이다	neutral
춘천시 사북면 오탄리로부터는 18.7km 떨어져 있다	neutral
확산을 막기 위한 노력들도 추진되고 	neutral
환경부는 인제 소양호 이남에서	neutral
양성개체 발견 이후 감염 확산을 차단하기 위해 발생지점 주변에 2차 울타리를 설치키로 했다	neutral
춘천에 이르는 광역울타리를 설치키로 했다.	neutral
집중 점검키로 했다	neutral
총기포획을 유보하되 특별포획단을 투입해 포획덫 등 포획도구를 활용한 집중 포획을 실시할 계획이다	neutral
정밀검사 등 긴급 방역조치를 시행키로 했다	neutral
주변도로 등을 매일 소독할 계획이라고 밝혔다	neutral
저작권자 	neutral
환경부에 강력 촉구했다	negative
우려했다	negative
농가들은 무능한 환경부의 멧돼지 방역관리 실패를 더 이상 좌시할 수 없다고 	negative
시행할 것을 촉구했다	neutral
중단할 것을 촉구했다	negative
요구했다	negative
153번쨰 기사입니다	neutral
내년 외식업계 트렌드는 코로나 19가 주도할 것으로 보인다	neutral
친환경 가치는 올해에 이어 내년에도 중요한 키워드가 될 전망이다	neutral
농림축산식품부는 최근 ‘2021 식품	neutral
진화하는 그린슈머 △취향 소비 △안심 푸드테크 △동네 상권의 재발견을 선정	neutral
최종 선정된 키워드들이다	neutral
추구하는 현상을 말한다	neutral
가치를 공유하는 키워드다	neutral
코로나도 빼 놓을 수 없는 이슈다	neutral
이번에 선정된 5가지 키워드 중 	neutral
원하는 식사를 선호	neutral
트랜드라는 공통점을 가지고 	neutral
저작권자 	neutral
소비자 가격은 2배 넘게 오른 것으로 분석됐다	neutral
가량 급등했다	positive
올랐다는 계산이 나온다	neutral
같은 상승폭을 기록했다	neutral
) 순이었다	neutral
)가 가장 컸으며 그 다음이 돼지갈비	neutral
저작권자 	neutral
올해도 수고했어	neutral
다양한 특별 기획전을 실시한다.	neutral
건강하게 마무리하자는 의미를 담아 기획되었다	positive
이상 할인되는 기획전 상품에는 건강을 챙길 수 있도록 고단백 부위인 앞다리살과 뒷다리살이 포함된다	neutral
기획전 상품 구매 시 청정원 고기 양념 소스를 사은품으로 받을 수 있다	positive
올해의 마무리를 캔햄과 함께 고마운 마음을 표현할 수 있도록 한돈을 사용한 캔햄의 할인 및 선착순 쿠폰 증정 기획전도 병행한다	positive
할인쿠폰을 선착순으로 증정한다	positive
몰을 많이 이용해주시면 감사하겠다	positive
농가와 함께 작은 위로를 건네고 	positive
시세가 다시 3천원대로 하락할 것으로 전망	negative
다	neutral
농경연은 내년 한돈 가격 전망을	neutral
소비에 따라 달라질 수 있지만 	neutral
평년(3천945원)에 비해 다소 낮을 것으로 예측했다	neutral
가량 낮을 것이란 전망이다	neutral
또 돼지 도축두수는 163만~167만마리로 전년 동월	neutral
예측치는 이보다 더 높을 수 있다는 단서를 달았다	neutral
다른 전망치가 제시됐다	neutral
낮을 것으로 예상했다	neutral
현재보다 부정적일 것이라고 응답한 가구수가 많았다는 설명이다	negative
가량 높을 것으로 내다봤다	neutral
수준에는 못 미칠 것이란 분석이다	neutral
경기 침체 시 2021년도 가격 전망	neutral
돼지 값 형성에 중요한 공급량은 올해보다 한돈은 줄고 	neutral
감소할 것으로 추산됐다	negative
농경연은 예상했다	neutral
돼지 도축 마릿수 전망	neutral
저작권자 	neutral
양돈타임스 무단전재 및 재배포 금지임정은다른기사 보기 154번쨰 기사입니다	neutral
축산분야에서도 공익직불제 도입이 추진될 전망이다	neutral
농어촌특별위원회는 최근 ‘축산농가 경영안정화 방안	neutral
환경이 조화되는 지속가능한 농축산업을 실현을 목표로 추진되고 	positive
특히 농특위는 축산 경영 안정화를 위해 축산분야에서도 공익직불제 도입을 검토하고 	positive
지역자원기반 경축순환 활성화 사업에 참여하는 농가를 대상으로 직불금을 지급해 농가들의 사업 참여를 유도하겠다는 것이다	neutral
포함시켜 축산분야에서도 공익직불제 지급이 가능토록 법 개정이 추진되고 	neutral
농특위는 적정 사육 두수 관리제 도입도 추진하고 	neutral
향후 축산농가와의 마찰이 예상되고 	negative
최근 야생멧돼지	neutral
돼지열병)와 유사한 것으로 분석되고 	neutral
발생 흐름과 유사해지고 	neutral
경북 북부 지역으로 확산이 우려되고 	negative
상재화를 막을 마지막 골든타임이라는 지적이다	negative
FMD	neutral
돼지열병박멸위원회에 따르면 야생멧돼지서 돼지열병 항원?	negative
항체 검출 지역은 2016년 이후 경기 연천	neutral
충북 충주에서 포획된 야생멧돼지서 돼지열병 항원	negative
항체가 검출되면서 내륙지역으로 남하하고 	neutral
경기도와 강원도 내 지속적 순환감염이 추정되고 	negative
발생 흐름이 이와 상당히 유사하다	neutral
북→남쪽 방향으로 점진적 확산추세를 보이며	neutral
발생 지역을 유추해 볼 수 있다	neutral
내륙지방에서도 ASF가 검출될 가능성이 높아지고 	negative
이에 전문가들은 야생 멧돼지 소탕 등 특단의 조치가 시	neutral
되지 않는다면 ASF 상재화로 접어들면서 	negative
155번쨰 기사입니다	neutral
바이러스가 설악산을 이미 오염시키고	negative
소독등 긴급 방역조치를 실시했다고 	neutral
가아리 등 기존 발생지점과는 6	neutral
이번에 발견된 개체는 환경부가 설치한 울타리 밖에서 발견된 것이다	neutral
설악산은 이미 ASF로 오염됐을 가능성이 높다고 	negative
시점에 이미 감염된 개체로 추정된다	negative
설악산 구역보다 더 남하한 지역인 홍천	neutral
전국 상재화의 단초라고 지적하면서 	negative
전략으로 전환을 촉구하고 	neutral
추가로 설치해야 한다는 입장을 환경부에 건의했다	neutral
현재 횡성	neutral
감염 야생멧돼지의 남하를 최대한 저지할 수 있다는 것	neutral
설치를 해줄 것을 요청했다	neutral
156번쨰 기사입니다	neutral
올해는 겨울 시작과 함께 한파도 시작됐다	neutral
양돈농가들도 추위에 철저한 대비가 요구되고 	neutral
서울 아침 최저기온이 -11.2도를 기록했으며 강원 철원은 	negative
전국 곳곳에서 연일 올 겨울 최저기온을 경신했다	positive
평년에 비해서도 10도 안팎 낮은 기온이다	neutral
기상청은 이번 추위가 내년 초까지 이어질 것으로 내다보고 	neutral
평년(-1.1~0.3℃)보다 낮을 것으로 예보했다	negative
그 이후로는 평년과 비슷하거나 다소 높을 것 관측했다	neutral
기온 변동폭이 클 것으로 예상해 기습 추위의 가능성도 제기되고 	neutral
이처럼 한파가 맹위를 떨치면 양돈	negative
돼지 관리도 달라져야 한다는 지적이다	negative
최근 농촌진흥청은 한파와 대설이 예상되는 만큼 양돈 등 축산농가의 재해 대비에 주의를 당부했다	negative
영양 공급에 주의를 기울여야 한다	negative
라고 지적하고 	negative
겨울철에 집중 발생하고 있는 만큼 전기설비를 점검하는 등 화재 예방에도 힘써야 한다고 	negative
위험도 높은 시기	negative
적극 나설 것을 당부하고 	neutral
저작권자 	neutral
양돈타임스 무단전재 및 재배포 금지임정은다른기사 보기 157번쨰 기사입니다	neutral
멧돼지 폐사체가 발견된 영월지역은 광역울타리로부터 62km 떨어진 지역이다	neutral
위험주의보가 발령됐다	negative
강원도 영월군 주천면 신일리에서 발견된 멧돼지 폐사체에서 아프리카돼지열병 바이러스가 검출됐다고 	negative
이로써 야생멧돼지 아프리카돼지열병이 발생한 시군은 11개로 늘었다	neutral
이에 농림축산식품부(장관 김현수)는 야생멧돼지 검출지점	negative
방역관리를 실시한다.	neutral
영월 검출지점 10km내 양돈농장은 총 5호	neutral
방역 관리 강화를 시달했다	negative
정밀검사한 결과 모두 음성으로 나타났다	neutral
158번쨰 기사입니다	neutral
전국으로 확산될 여지가 있다	neutral
농가들이 촉각을 곤두세우고 	neutral
백두대간을 타고 	neutral
야생 멧돼지 폐사체가 발견됐다	negative
강원 영서 지역에서 확산되던 ASF 바이러스가 남동진하면서 	neutral
더욱 우려스러운 점은 영월군에서 차령산맥과 소백산맥을 따라 전국 확산될 우려가 크다는 점이다	negative
전북 지역까지 연결돼 있다.	neutral
사정권에 들어왔다고 해도 과언이 아니다	neutral
이에 전문가들은 아프리	negative
접경 지역 방역 중심에서 양돈장 중심으로 방역을 전환해야 한다고 	negative
협회가 주도하는 현장 중심의 방역 정책으로 전환돼야한다는 목소리도 높아지고 	neutral
대응체계로 탈바꿈해야 한다	neutral
이준길 전 ASF 비상대책위원장도	neutral
생산자 단체가 주도하는 방역정책으로 전환해 나가야 한다	neutral
고 제언했다	neutral
159번쨰 기사입니다	neutral
아프리카돼지열병) 선제적 확산 방지를 위해 전국을 권역별로 관리키로 했다	neutral
관련업계가 크게 우려하고 	negative
확산될 수 있는 엄중한 상황이라고 진단하면서 	negative
특히 전국 ASF 선제적 확산 방지를 위해 발생 위험도에 따라 단계적으로 권역을 설정	neutral
관리하겠다는 것	neutral
경남서부 등이다	neutral
진입이 금지된다	neutral
방역 점검 등 강화된 방역 조치가 시행될 것으로 보인다	neutral
주변이 고립되면서 해당 지역 양돈농가들의 경제적으로 큰 손실이 예상되고 	negative
조치라고 반대하고 	negative
농장 경영에 큰 타격을 입을 것이라고 불만의 목소리를 높이고 	negative
권역보다는 도 단위 중심의 대권역으로 설정해 양돈농가들의 경제적 피해를 최소화하는 방안으로 정책이 추진해야 한다고 	neutral
160번쨰 기사입니다	neutral
이어 올해는 생산비 상승으로 고전이 우려되고 	negative
임금 등 주요 비용이 모두 상승하면서 	neutral
올해 107.9로 상승할 것으로 추산했다	neutral
농가구입가격지수는 가계용품을 제외한 농업용품 관련비용을 말한다	neutral
곡물가 등 국제 원자재 가격 상승이 주된 원인이다	neutral
농업 용품 가격이 상승하며 노임과 임차료도 각각 2.2	neutral
경영부담이 가중될 것으로 보인다	negative
악화될 것이라고 전망했다	negative
저작권자 	neutral
양돈타임스 무단전재 및 재배포 금지임정은다른기사 보기	neutral
올해 한돈 평균 가격이 작년보다 높은 4천200	neutral
수준까지 하락할 수 있다고 	negative
중장기 돼지 값에 대해 전망했다	neutral
감소할 것으로 전망	negative
수입량은 주요국 수입 단가 상승에도 불구 환율 하락 및 수입육 도매 원가 하락 영향으로 작년	negative
증가한 34만~36만톤으로 증가할 것으로 예측됐다	neutral
해와 비슷함에도 한돈 출하 감소 영향으로 4천200	neutral
수준까지 하락할 수 있다고 	negative
미만 농가는 수익 악화를 예상했다	negative
이를 환산할 시 4천572원으로 나타나 마이너스 경영이 전망됐다	negative
농경연은 중장기 전망을 통해 2022년 이후 도매 가격은 도축 마리 증가 속 소득 증가와 육류소비 증가 등으로 상승 추세가 지속	neutral
161번쨰 기사입니다	neutral
정부의 방역 정책 변화를 촉구했다	negative
한돈협회는	neutral
정부의 권역화 추진 대응 방안에 대해 모색했다	neutral
대책으로 한돈 생태계를 마비시킬 것이라는데 동의했다	negative
발생했을 비상 상황에서만 실시하는	negative
발생 확률을 낮출 필요가 있다	neutral
이라고 우려했다	negative
앞으로는 효과 없고 부실하게 설치된 광역 울타리 대신 양돈농가 주변 울타리 설치가 더욱 효과적일 것	negative
농가를 잡을 태세	negative
최소화를 위해서는	neutral
야생멧돼지와 일반농가를 분리한 방역 대책으로 전환	neutral
정부의 방역 정책 패러다임이 이제는	neutral
바뀌어야 한다	neutral
평균 돈가도 3천원대에 머물렀다	negative
상승했다	positive
와 비교해 소폭 줄었다	neutral
한돈 평균 가격은 전년 대비 큰 폭의 오름세로 출발했지만 시장의 기대에는 못 미쳤다	negative
이는 산지 출하물량 증가 속 코로나 1	neutral
가정 내 소비 외 이렇다 할 소비 동력이 부족했던 영향이다	negative
영향도 한 원인으로 추정된다	negative
발생 건수가 1천건을 넘어섰다	negative
확진되면서 야생멧돼지 ASF 검출 1천번째를 기록했다	negative
첫 발견된지 483일째만이다	neutral
야생 멧돼지에서 ASF가 검출되는 셈이다	negative
발생 지역별로 살펴보면 	neutral
확산을 방지하기 위해 전국을 4개 지역	neutral
검출이 증가하면서 방역당국이 포천 지역 내 방역을 강화하고 	neutral
162번쨰 기사입니다	neutral
사업량 10조원 달성을 목표로 사업을 추진키로 했다	neutral
자회사 대표이사가 참석한 가운데 ‘2021년도 축산경제 경	neutral
협약식’을 개최했다	neutral
농협사료 대표이사와 농협목우촌 대표이사를 대상으로 체결됐다	neutral
당부했다	positive
적극 추진키로 했다	positive
생계안정비용이 지급된다	positive
수매 이후 15개월만이다	neutral
일부개정안을 행정 예고했다	neutral
수매 등 적극적 방역조치를 실시했다	neutral
농가가 위험 지역 수매에 참여했다	neutral
희망 수매 농가들은 그동안 법적 지원 근	neutral
가 없어 생계안정자금을 지원받지 못하고 	negative
긴급안정비용을지원키로 했다	positive
생계 비용이 지원될 계획이다	positive
축산관련단체협의회가 도축세 부활에 대해 반대 입장을 표명했다	negative
축산회관에서 생산자단체 대표자 회의를 열고 외국인 근로자 고용허가 주거시설 기준 강화	neutral
가짜고기 시장 잠식	neutral
반대 입장을 명확히 했다	neutral
지방세 세목 체계 간소화 등으로 폐지됐었다	neutral
법안 발의를 추진할 것으로 알려졌다	neutral
예상된다며 우려를 나타냈다	negative
가격 경쟁력 약화도 예상했다	negative
향후 도축세 부활 추진 시 강력 저지할 계획이라고 밝혔다	neutral
지난해 돼지고기보다 돼지 부산물 수입이 더 큰 폭으로 줄었다	positive
식육가공품 수입도 처음으로 감소했다	negative
최근 육류유	neutral
감소했다	negative
더 큰 폭의 감소세를 보였다	negative
식육가공품 수입도 줄었다	neutral
감소했다	negative
적었다	neutral
증가했으나 역시나 감소세가 꺾였다	negative
저작권자 	neutral
강세를 보여 한돈 소비에 악영향을 미치고 	negative
상승했다	positive
연동되지 못한 것으로 분석되고 	negative
이 같이 산지가격과 삼겹 소비자가격간 가격 왜곡 현장이 발생하고 	negative
이는 돼지고기 부위별 심각한 소비 불균형으로 풀이된다	negative
목살 등 구이용 고기에 대한 수요가 증가하	neutral
소비가 저조해 재고 적체로 육가공업계가 삼겹 판매가만 높게 유지하고 	negative
다릿살 같은 저지방 부위 소비 증가가 시급하다	negative
163번쨰 기사입니다	neutral
확산이 우려되고 	negative
양성으로 확진됐다	negative
이에 방역당국은 강릉	neutral
위험 주의보를 발령하면서 	negative
또한 방역 실태 현장 점검을 통해 복합 영농인 방역 관리 강화 및 검출 지점 인근 도로	neutral
집중 소독을 실시했다	neutral
범위가 더욱 넓어질 것을 우려하고 	negative
전략으로 전환을 촉구하고 	neutral
한편 지난 15일 현재 전국 멧돼지 ASF 검출 건수는 1천75건으로 경기 4개 시군에서 496건	neutral
164번쨰 기사입니다	neutral
돼지 건강관리에 주의를 기울	neutral
야 한다는 지적이다	negative
이번 겨울은 유난히 추웠다	negative
기습 한파도 잦았다	negative
다가오는 봄은 예년보다 높은 기온이 예보돼있다	neutral
기온 변화가 다른 해보다 클 수밖에 없는 것이다	neutral
기온이 대체로 평년보다 높고 	neutral
대비를 더 철저히 해야 하는 것이다	neutral
생체 대사 기능과 면역체계 기능이 낮아진다	negative
질병 저향력이 떨어지는 시기라는 얘기다	negative
무엇보다 호흡기 질병의 위험이 높아지는 만큼 환경 관리에 특히 신경써야 한다고 당부하고 	neutral
내외부 소독과 청소가 중요한 시기다	neutral
먼지와 각종 병원성 세균의 농도를 낮추는 것이다	positive
분변 등을 제거한다	neutral
약액이 사료 급이기에 남아 있지 않게 주의한다	neutral
돼지를 들이기 전에 내	neutral
돼지 사이의 교차 오염을 예방할 수 있다	positive
건조한 환경이 질병 발생의 원인이 될 수 있는 만큼 환절기에는 환경에 대해서도 더 세심한 관리가 요구된다	negative
내 적정 온도를 유지하면서 단열 시설물은 환절기	neutral
뒤 제거하는 것이 좋다	neutral
피해를 줄이도록 한다	neutral
환기는 	neutral
밤에는 환기량을 줄여 내부 온도가 급격히 낮아지는 것을 막는다	neutral
수준으로 관리하고 외부 공기가 내부의 공기와 적절하게 섞여 바깥으로 나갈 수 있도록 한다	neutral
강조하며 동시에 차단방역과 주변 소독을 철저히 실시해 농장의 생산성 낮추는 요인을 줄이는 노력이 필요하다고 	neutral
저작권자 	neutral
양돈타임스 무단전재 및 재배포 금지임정은다른기사 보기 165번쨰 기사입니다	neutral
말레이시아에서 처음으로 ASF(아프리카돼지열병	negative
이에 방역당국이 국경 검역을 강화키로 했다	neutral
농림축산식품부(장관 김현수)는 지난달	neutral
대하여 국경검역을 강화하였다고 	negative
혹시	neutral
주)에 대한 전수검색을 실시키로 했다	neutral
또한	neutral
주의를 당부했다	negative
농축산부는	neutral
축산물을 휴대하여 입국하는 행위는 금지되어 있으니 국경검역에 적극 협조하여 줄 것을 요청했다	neutral
구제역 특별방역대책 기간이 2주 연장된다	neutral
다만 	neutral
구제역 특별방역대책 기간을 이달 14일까지로 조정했다	neutral
구제역의 경우 일부 농장에서 백신 접종 관리가 미흡한 사례가 발견된데 	negative
중국 등 주변국 발생도 이어지고 있다는 것도 연장 결정에 영향을 미쳤다	neutral
소 분뇨의 권역 밖 이동 제한 조치도 이어가기로 했다	neutral
장기간 분뇨 이동이 금지됐던 만큼 연장 기간에는 사전 검사 후 이상이 없는 경우 권역 밖으로 이동될 수 있도록 지도 관리할 방침이다	neutral
환경 중 구제역 바이러스 순환 여부 확인을 위해 축산차량 이동이 많은 소	neutral
이달 중 환경 검사를 실시하고 백신 접종 상황 등 위험요인을 고려해 추가 연장 여부를 다시 검토키로 했다	neutral
저작권자 	neutral
양돈타임스 무단전재 및 재배포 금지임정은다른기사 보기 166번쨰 기사입니다	neutral
구제역 백신 항체 형성률 기준이 법으로 명시될 전망이다	neutral
이 대표 발의한 가축전염병예방법 개정안을 통과시켰다	neutral
이번 개정안은 가축의 소유자 등에게 구제역 예방 접종 등의 조치를 명할 수 있도록 되어	neutral
법적 근거가 미흡해 소송이 제기되고 	negative
농가와 정부간 구제역 백신 문제의 갈등의 골은 더욱 깊어질 것으로 예상되고 	negative
향후 각종 정부 지원 사업에서도 배제가 되는 등 선의의 피해를 받을 것으로 우려하고 	negative
전체 돼지고기 수입량 감소에도 삼겹살은 줄지 않았다	neutral
독일산 삼겹살 수입은 중단됐지만	neutral
른 유럽국가들이 그 빈자리를 채우고 	neutral
줄었다	neutral
줄었다	neutral
작년보다 돼지고기 수입 단가가 오른 영향으로 풀이된다	neutral
삼겹살은 되레 증가했다	negative
삼겹 수입량은 1월과 비슷한 1만600여톤을 기록했는데 	neutral
늘었다	neutral
그 차이가 확연하다	neutral
급감했다	negative
삼겹살이 수입되는 나라들은 모두 늘었다	neutral
196	neutral
늘어 ASF로 수입이 중단된 독일산 삼겹살 수입물량을 다른 유럽국가들이 대체하고 	neutral
저작권자 	neutral
임스 무단전재 및 재배포 금지임정은다른기사 보기 167번쨰 기사입니다	neutral
발생 시 수매에 참여했던 농가에 대해 비로소 	neutral
수매된 지 18개월 만이다	neutral
긴급안정비용을 지원한다고 	positive
재정적 근거가 없어 생계안정 지원이 어려웠다	negative
제도적 근거 마련과 필요한 예산을 확보했다고 강조했다	positive
생계안정을 목적으로 최대 18개월분까지 지원키로 했다	positive
이들 농가당 평균 지원 금액은 사육규모에 따라 1천200백만원	neutral
긴급안정비용을 3월 중순경 지급될 예정이다	positive
구제역 특별방역대책기간이 또 다시 2주간 연장됐다	neutral
동안 연장키로 했다	neutral
검역본부 현장점검결과 일부 농가에서는 방역관리 미흡사례가 확인되고 있어 안심할 수 없는 상황이라며 이 같이 연장키로 한 것	negative
밖 이동 제한 조치도 3월 28일까지 연장된다	neutral
동안 분뇨 이동을 금지한 점을 고려하여 이번 연장기간 동안에는 사전검사 후 이상이 없는 경우에 한해 제한적으로 권역 밖으로 이동될 수 있도록 지도	neutral
환경 검사를 실시할 계획이다	neutral
사회거리 두기 단계를 2주간 더 연장했다	neutral
이상 금지 모임도 지속되면서 한돈 소비 위축이 심화될 것으로 우려되고 	negative
농가들의 시름이 깊어지고 	negative
상승했으나 이후 다시 3천원대로 하락했다	negative
이는 무엇보다 코로나 확산 지속으로 한돈 소비가 주춤한 영향으로 풀이된다	neutral
발생으로 가동이 중단되는 등 가격에 영향을 미치는 요인들도 생겨나고 	neutral
지방 지역의 경우 거리두기 완화 이후 한돈 판매가 소폭 나아지는 모습을 보이고 	neutral
잡육은 여전히 어려운 상황이 이어지고 	negative
안팎 형성에 그칠 것으로 전망되고 	negative
168번쨰 기사입니다	neutral
양돈사료량이 55만톤 이하를 기록했다	neutral
기준 전년 대비로도 감소했다	negative
각각 줄었다	neutral
이는 올해 돼지 사육두수가 전년 대비 감소한 가운데 2월 설 연휴로 작업 일수가 준 영향이다	neutral
이에 하루 생산량으로 따져보면 2월이 3만여톤으로 전달과 지난해 동월에 비해서는 각각 8	neutral
양돈사료량도 전년 대비 감소하면서 	neutral
감소했다	neutral
다소 차이는 있다	neutral
가량 줄었다	neutral
자돈용과 번식돈용은 비육돈용에 비해 감소폭	neutral
번식돈용 가운데서는 번식용 모돈사료가 1월에 이어 2월에도 전년 동월대비 증가했다	neutral
늘어 향후 사육두수 증가로 이어질지 주목된다	neutral
저작권자 	neutral
양돈타임스 무단전재 및 재배포 금지임정은다른기사 보기 169번쨰 기사입니다	neutral
한돈시장이 정반대의 전개를 보였다	neutral
한돈시장이 코로나 이전 흐름을 되찾아가는 것인지 주목된다	neutral
문턱도 넘지 못하는 약세를 형성했다	negative
시세가 지난해보다 하락한 것으로 보였다	negative
들어 평균 4천32원으로 오르며 역전이 일어났다	neutral
지난해와의 차이를 더 벌렸다	neutral
기존의 계절적 흐름에서 크게 벗어난 시기였다	neutral
코로나가 외식과 급식수요를 차단하면서 하락세를 피할 수 없었다	negative
한돈시장만 보면 코로나 이전 흐름을 쫓아가고 	neutral
원서 넷째주 4천244원으로 올랐다	neutral
다른 것은 몇 가지 차이점 때문으로 해석된다	neutral
불확실성이 크게 약화됐다는 점이다	negative
시작됐던 지난해는 향후 시장에 대해 불안감이 더 컸다면 올해는 백신 접종과 함께 일상 복귀에 대한 기대감도 어느 정도 작용한 것으로 풀이된다	negative
저작권자 	neutral
양돈타임스 무단전재 및 재배포 금지임정은다른기사 보기 170번쨰 기사입니다	neutral
돼지 출하두수가 역대 3월 중 최고치를 기록했다	positive
분기로는 출하가 지난해보다 다소 줄었지만 	neutral
출하물량으로는 역대 최고치를 기록했다	positive
감소한 영향으로 올해 돼지 출하물량은 지난해보다 감소할 것으로 예상됐다	negative
출하가 지난해보다 크게 늘면서 1분기로는 470만마리로 전년 동기 474만마리 대비 0.8	neutral
적지만 	neutral
한 바 있다	neutral
앞으로도 사육두수 대비 출하 증가세가 이어질지는 장담하기 어렵다	negative
이번 겨울은 유난히 춥고 길었던 때문이다	neutral
이에 그 여파가 향후 출하물량에 반영될 가능성도 점쳐지고 	neutral
한편 농경연 관측 결과 올해 사육두수	neutral
저작권자 	neutral
양돈타임스 무단전재 및 재배포 금지임정은다른기사 보기 171번쨰 기사입니다	neutral
한시적으로 관세가 철폐된다	neutral
이 같은 내용의 국제 곡물 수입가격 부담 완화 대책을 확정	neutral
국내 물가 상승이 우려된데 	negative
수입 통관 관련 절차를 개선한바 있으며 이번에 업계 비용 부담 완화를 위해 추가 조치를 마련한 것이다	positive
P 인하해 적용키로 했다	neutral
연말까지 소요 물량 128만톤에 대해 한시적으로 긴급할당관세 0	neutral
그동안 운영하던 국제곡물 자문위원회(위원장 농림축산식품부 식량정책관)를 국제곡물 수급대책위원회(위원장 농축산부 기획조정실장)로	neutral
면밀히 모니터링하고 업계와 긴밀히 협의해 나가기로 했다	neutral
저작권자 	neutral
국경 검역 빗장이 풀리고 	neutral
이하 농식품부)는 최근 ‘아일랜드와 프랑스 쇠고기 수입위생조건	neutral
그동안 수입허용 절차가 진행됐다	neutral
수입 허용 절차는 총 8단계로 진행됐다	neutral
(① 수입허용가능성 검토	neutral
②가축위생설문서 송부	neutral
③답변서 검토	neutral
④현지조사	neutral
⑤수입허용여부 결정	neutral
⑥수입위생조건안 협의	neutral
⑦수입위생조건 제정	neutral
수입 쇠고기의 안전성이 확보되도록 상대국과 수입 위생 조건안을 협의했다고 	neutral
전문가들로 구성된 가축방역심의회의 자문 과정을 거쳤다고 강조했다	neutral
가공품은 수입 대상에서 제외했다고 	neutral
또한 쇠고기	neutral
판단되는 경우 수입을 재개할 수 있도록 조건을 마련했다	neutral
해당 수입위생조건안을 국회에 제출하여 심의를 요청할 계획이라고 밝혔다	neutral
국회 심의 이후에는 수입위생조건안을 확정	neutral
절차가 이어질 예정이다	neutral
한편 2000년 유럽산 쇠고기에 대한 수입이 금지된 이후	neutral
저작권자 	neutral
양돈타임스 무단전재 및 재배포 금지임정은다른기사 보기 172번쨰 기사입니다	neutral
정부가 소에 도입했던 이력제 사업을 전국 양돈장 모돈에도 확대 적용을 추진하고 	neutral
축산물의 안전성을 확보하고자 소 이력제를 실시하고 	positive
전국 양돈장을 대상으로 시범사업이 진행될 것임을 시사했다	neutral
전체에 귀표 부착을 통해 농장은 모돈에 대한 주요 사항을 개체 관리카드에 기록하고	neutral
이 같이 정부의 모돈 이	neutral
업계는 난색을 표하고 	negative
가격 하락을 불러올 수 있다는 지적도 제기되고 	negative
자조금에서 충당을 종용하고 있어 논란이 되고 	negative
추진해야 한다고 한 목소리를 내고 	neutral
농가의 주의가 요구되고 	negative
차단방역에 집중키로 했다	neutral
시험소에 따르면 올해 PED 발생 17건 중	neutral
영천지역에 집중 발생하고 	neutral
높아 양돈농가의 경제적 피해가 큰 질병이다	negative
이는 축사 위생관리가 어려운 동절기	neutral
특히	neutral
위험에 노출되어 있어 각별한 주의가 요구된다	negative
김영환 경상북도동물위생시험소장은 	neutral
당부했다	neutral
저작권자 	neutral
양돈타임스 무단전재 및 재배포 금지임정은다른기사 보기 173번쨰 기사입니다	neutral
양돈장 생산 성적 상승 흐름이 한 풀 꺾였다	negative
두로 나타났다	neutral
초반대로 다시 급락했다	negative
이 같이 생산 성적 하락 배경에는 지난 겨울 유난히 춥고 	negative
겨울 양돈장 비육 관리에 큰 어려움을 겪은 것으로 보인다	negative
생산성 저하에다 돼지 값 약세로 힘겨운 겨울을 보낸 것으로 나타났다	negative
국내 모돈 특성이 다산형으로 변화되고 	neutral
검정 성적을 분석한 결과 평균 산자수(요크셔 생존 산자수)는 13.14두로 전년 동기보	neutral
0.02두 향상됐다	neutral
매해 꾸준히 상승하면서 	neutral
산자 능력 외 산육 능력 성적은 감소하고 	negative
90kg도달일령은 131	neutral
3일로 지난해보다 0	neutral
일당증체량도 717.1g으로 1.1g 감소됐다	neutral
개량되면서 국내 종돈도 다산성 특성으로 개량되고 	neutral
다산모돈의 장점을 극대화할 수 있는 사양관리가 필요하다고 	neutral
축산물을 활용한 가정 간편식 중 스테이크와 불고기가 가장 인기가 높은 것으로 조사됐다	positive
이들 제품은 대부분 수입산을 활용해 만든 제품인 것으로 나타났다	neutral
이상 증가한 것으로 타났다	negative
가구 증가에 따른 식생활 변화로 풀이된다	neutral
많이 판매되고 있는 제품은 스테이크 제품이며	neutral
그러나 소기기 스테이크 제품 모두	neutral
대부분 수입산을 사용한 것으로 조사됐다	neutral
국민들의 스테이크 인기와 무관치 않은 것으로 분석되고 	neutral
2021년도 1분기 한돈 정육 수출 현황	neutral
올해 한돈 지육 수출이 크게 늘었다	neutral
목소리를 높이고 	neutral
대비 배 이상 증가한 것으로 나타났다	positive
수출 확대 노력으로 풀이된다	neutral
수출국에서 원하는 가격과 근접해지면서 올해 수출 물량이 늘었다	neutral
업계는 업계의 노력으로 이룬 한돈 수출 성장세를 이제는 정부가 적극 나서 	neutral
국가간 검역 협정 체결에 적극 나서야 한다는 것이다	neutral
물량은 미미한 수준이다	positive
역 협정국 확대 지원이 절실하다	neutral
174번쨰 기사입니다	neutral
출하물량 감소 속 한돈 평균 가격도 크게 상승했다	neutral
각각 감소했다	negative
감소했다	neutral
이처럼 돼지 출하가 줄면서 4월 평균 한돈 시세는 4천627원으로 지난해 동월 4천286원에 비해 8.0	neutral
한돈 상승의 원인은 소비 증가 요인보다 공급물량이 주도했다	neutral
가량 적은 물량이다	negative
도매시장 출하물량도 급감하면서 	negative
이에 따라 5월도 강세를 이어	neutral
지표로 확인되고 있어 소비 회복에 대한 기대감도 피어나고 	positive
175번쨰 기사입니다	neutral
안녕하십니까	neutral
존경하는 전국 한돈농가 여러분	positive
발생했다는 소식에 안타까운 마음입니다	negative
점에서 상심이 크실 것으로 생각됩니다	negative
정부의 지원도 절실히 필요한 사항입니다	neutral
방역	neutral
농장밀집지역 울타리 조속설치 등을 요청하고 	negative
바라는 마음에 다음과 같은 당부를 드립니다	neutral
철저한 소독을 당부드립니다	neutral
등 방역수칙을 철저히 준수 바랍니다	neutral
유입 가능성을 막아 주시기 바랍니다	neutral
돼지 방목사육을 금지해주시기 바랍니다	neutral
텃밭 재배 등 양돈농장 관계자의 영농활동을 자제해주시길 당부드립니다	neutral
할 경우에는 방역당국에 신고와 방역조치를 하여 주시기 바랍니다	neutral
발생지역 입산금지에 동참을 부탁드립니다	neutral
군 내 입산이 무기한 전면 금지됩니다	neutral
이 지역외의 지역에서도 양돈관계자의 산행 활동을 최대한	neutral
자제해 주시기 바랍니다	neutral
농장 주변에 차단 울타리 설치 등을 강력 요청 하면서 ASF 확산 방지를 위해 적극 노력하겠습니다	positive
2021년	neutral
5월	neutral
한돈자조금관리위원장 하태식 배상	neutral
176번쨰 기사입니다	neutral
성수기 한돈 소비를 위태롭게 하고 	negative
이어 이달 중순 현재 2천400원대를 넘어섰다	neutral
코로나 여파로 한돈 삼겹살 가격이 강세를 기록했던 지난해 5	positive
더 오를 가능성도 있다	neutral
가능성도 없지 않다	negative
수입 냉장 쇠고기와 가격 역전도 벌어졌다	neutral
한돈 삼겹살 가격이 더 높은 상태다	neutral
최근 10년간 월별 한돈 삼겹 소비자 가격 현황	neutral
최근 도매 시세 상승을 감안하더라도 비싸다	neutral
중순 현재 도매시장 평균 경락 가격은 4천984원으로 전달 4	neutral
가량 상승했다	neutral
기록했던 지난해 5월에 비해서도 낮다	negative
성수기 한돈 소비의 걸림돌이 될 수도 있다	negative
한돈 소비와 가격 상승을 제한할 수 있어 	neutral
저작권자 	neutral
멧돼지 포획을 확대해 줄 것을 강력 요청했다	negative
협회는 최근 강원 영월에서 양돈장 ASF 발생과 관련	neutral
있는 등 전국 확산이 우려되고 	negative
발생 위험은 해소되지 않을 것으로 전망했다	negative
야생 멧돼지 관리 대책을 환경부에 강력 요구했다	negative
가 더 이상 남하되지 않도록 해야 한다고 	neutral
멧돼지 포획을 요청했다	neutral
멧돼지 포획 환경을 제공해 줄 것도 요구했다	neutral
업계의 한 관계자는	neutral
이라고 우려했다	negative
177번쨰 기사입니다	neutral
양돈농가 수익이 호전된 것으로 조사됐다	positive
미만 소규모 농가는 적자를 피하지 못했다	negative
지난해 비육돈 두당 순수익은 평균 4만6천949원으로 19년 6천339원에 비해 4만1천원(640.6%	neutral
수입이 개선된 때문으로 두당 총수입이 36만2천원으로 19년 32만9천564원보다 9.9	positive
줄면서 	positive
줄었다	neutral
감소하면서 전체 생산비를 낮췄다	negative
경영 환경은 개선된 것으로 나타났지만 	positive
가량 많았던데 비해 1천마리 미만 규모 농가는 두당	neutral
1만4천470원의 적자를 본 것으로 집계됐다	negative
수익성의 차이는 확연했다	positive
생산비가 수익을 결정지었다	neutral
이상 차이가 발생해 적자와 흑자 경영을 가르는 결정적인 차이를 만들었다	negative
저작권자 	neutral
양돈타임스 무단전재 및 재배포 금지임정은다른기사 보기 178번쨰 기사입니다	neutral
상황서 가정 내 한돈 소비 기반은 굳건했다	neutral
앞으로도 한돈의 소비가 현 수준을 유지할 수 있을까에 대해 의문을 갖게 하는 변화도 있었다	negative
올라오는 동시에 앞으로는 수입육과의 경쟁도 쉽지 않을 수 있다는 조짐들이 나타나서다	negative
식품행태조사’를 발표했다	neutral
쇠고기	neutral
대조를 보였다	neutral
많이 소비한다는 가구 비중이 62	neutral
반대로 다소 높은 것으로 나타났다	neutral
선호 육류 조사에서는 돼지고기가 밀리는 현상이 더 두드러졌다	negative
P 높아져 대조를 보였다	neutral
다른 육류를 선택한 비중은 더 높았다	neutral
경계도 필요할 것으로 보인다	neutral
국내산을 주로 구입하는 것으로 조사됐다	neutral
지난해 급격히 상승한 것으로 나타났다	neutral
높아 향후 가정 내 소비에서 수입육 비중이 더 높아질 가능성이 높은 것으로 나타났다	neutral
이 밖에 돼지고기 구입 행태에 대한 조사 결과를 보면 돼지고기 구입하는 가구의 대다수	neutral
조사됐다	neutral
그밖에 비포장육을 구입하는 가구는 41	neutral
)이 600g 단위로 구입하는 것으로 조사됐다	neutral
가구에 비해 높았으며 5인 이상 가구에서는 1천200g 비중이 29	neutral
구이용이 특정 부위 쏠림이 더 심한 것으로 조사됐다	negative
저작권자 	neutral
경기 북부지역의 생산성이 저하되고 	negative
차량 권역별 이동 제한으로 모돈 갱신이 원활치 못한 영향이다	negative
어려운 환경이 조성되면서 해당 농가들의 불만이 높아지고 	negative
발생 이후 포천도축장으로만 출하하고 	neutral
중점관리지역 방역 관리 강화 조치의 일환으로 경기도 북부 돼지를 타권역으로 출하할 수 없도록 조치했기 때문이다	neutral
모돈 출하에 큰 어려움을 겪고 	negative
방역 취약점이 발생하고 	negative
문턱까지 갔다 돌아섰다	neutral
초반대롤 오가다 21일부터 4천900원대로 떨어진 후에는 줄곧 5천원 이하를 지속했다	negative
평균 돈가도 4천991원으로 내려앉았다	neutral
가량 하락했다	neutral
전년 동월보다 낮아진 것은 5월이 처음이다	neutral
상대적으로 올해 돼지 값이 하락한 원인이 됐다	negative
대유행이 계속되면서 강화된 사회적 거리두기가 유지되는 등 한돈 소비 환경이 녹록치 못했다	negative
감소하면서 	neutral
이는 지난해 동월 141만두 대비 2.1	neutral
감소했다	neutral
저작권자 	neutral
올려야 한다는 주장이다	neutral
금요일 경매 활성화도 필요하다는 지적이다	negative
한돈협회는 최근 농협 고령축산물공판장에서 협회 임원 및 공판장	neutral
관계자들이 참석한 가운데 도매시장 활성화 대책을 모색했다	neutral
대까지 떨어진 것을 8	negative
중도매인을 비롯한 현장 관계자들은 도매시장 활성화를 위해서는 고품질 규격돈을 안정적으로 꾸준히 공급하는 것이 가장 중요하다는데 	neutral
문제점을 지적했다	negative
중도매인이 함께 노력한 덕분에 이전보다 상황이 개선되었다	positive
밝혔다	neutral
또 손종서 부회장	neutral
도매시장으로의 품질 좋은 규격돈	positive
균일한 돼지를 안정적으로 공급한다면	neutral
지역에 모범사례가 될 수 있다	neutral
수탁농가들이 단기간의 등락으로 손해를 감수해야 하는 상황이 발생할 수 있지만	neutral
179번쨰 기사입니다	neutral
돼지고기 수입량 감소세가 지속되고 	negative
삼겹살 수입도 계속 늘고 	neutral
연속 전년 동월대비 감소했다	negative
적었다	neutral
미국의 돼지고기 가격이 올해 급등하면서 	neutral
수입육의 시장성이 낮아진 것도 한 원인이다	negative
이처럼 수입육이 줄었지만 	neutral
과거 어느 시기보다 냉장 수입량이 많았다	neutral
역대 돼지고기 수입량이 사상 최고치를 기록한 해는 18년이다	neutral
올해보다 적었다	neutral
냉장 수입육은 주로 삼겹	neutral
이들 부위의 수입이 크게 증가한 것으로 추정된다	negative
최근 냉동 삼겹살 인기까지 겹치면서 	neutral
나머지 부	neutral
줄었다	neutral
감소했다	neutral
수입량은 전년비 각각 40.8	neutral
저작권자 	neutral
양돈타임스 무단전재 및 재배포 금지임정은다른기사 보기 180번쨰 기사입니다	neutral
김유용 서울대학교 교수정부 주관 하에 양돈수급조절협의회가 처음으로 개최됐다	neutral
이날 양돈수급조절협의회장에 김유용 서울대학교 교수를 선출하는 등 양돈 수급위원회가 본격적으로 활동을 개시했다	neutral
유예 기간을 거쳐 올 4월부터 기존 민간 중심의 축종별 수급조절협의회를 농림축산식품부 장관 소속의 자문기구인 축산물수급조절협의회를 설치	neutral
전체 축산물수급조절협의회 구성을 완료하는 한편 6월부터는 돼지 등 5개 축종별 소위원회를 구성해 운영키로 했다	neutral
양돈) 소위원회가 처음으로 개최됐다	neutral
내용으로 진행됐으며	neutral
협의회 위원장에 김유용 서울대학교 교수가 선출했다	neutral
양돈수급조절협의회장을 역임한 바 있다	neutral
수급 불안 가능성을 최소화하기 위해 양돈산업 수급 매뉴얼 구축 및 기준 설정이 필요함을 느껴	neutral
초과는 심각으로 구분하는 등 위기단계별로 생산자 등이 추진할 자율 수급 조절 대책을 마련할 계획이라고 밝혔다	neutral
181번쨰 기사입니다	neutral
농장간 전파 요인이 오염된 축산차량과 야생 멧돼지가 주요인으로 발표됐다	negative
권역화 관리 추진에 매진한 이유도 이 같은 원인으로 분석되고 	neutral
역학조사 결과’를 미발표하고 	negative
공개해 줄 것을 요청했다	neutral
발표돼 관심이 집중됐다	neutral
전파양상 분석을 토대로 연구한 논문이다	neutral
이에 이 논문이 정부의 공식 	neutral
발생 농장간 역학조사’라고 봐도 무방하다	neutral
논문 바로가기	neutral
데이터를 반영해 수리 모델을 통해 역학적으로 분석한 결과	neutral
전파가 주요인이라고 분석했다	neutral
그러나 멧돼지에서 양돈장으로의 ASF 전파 및 파주	neutral
김포로의 전파 원인은 규명하지 못했다	neutral
차량 움직임은 농장간 전파에 더 큰 위협이라고 분석	negative
권역화를 통한 분뇨	neutral
돼지 이동 금지 등 차량 이동 통제를 강화한 원인으로 분석된다	neutral
방역 대책을 비판하고 	negative
해당 지자체의 압박이 거세지고 	negative
기한 연장이 필요하다는 입장이다	neutral
해당 지역 농가들에게 기한 내 8대 방역 시설을 완료할 것을	neutral
미설치 농가에게 과태료를 부과할 것이라고 엄포하고 	negative
분석됐다.	neutral
기한을 연장해야 한다고 	neutral
토로했다	negative
이에 일부 농가는 휴업도 고려중인 것으로 알려졌다	neutral
토로했다	negative
단계별 시설 추진 등 속도를 늦출 필요가 있다고 	neutral
182번쨰 기사입니다	neutral
공동 비상대책위원회가 꾸려졌다	neutral
축산업 공동 현안 해결을 위해 축단협	neutral
축협조합장협의회	neutral
운영키로 의결했다	neutral
이날 회의에서 축산업 비대위는	neutral
△축산발전과제 대선 공약 채택 △대체 단백질 관련 범축산업계 대응 방안 강구 △근본적인 축산업 환경 규제 해결을 활동 목표로	neutral
며 강한 유감을 표명했다	negative
이에 이들은 농식품부가 축산 농정을 올바르게 펼 수 있도록 축단협 차원에서 대정부	neutral
대국회 농정 활동을 강화하겠다고 강조했다	neutral
축종을 불문하고 축산업계 전체가 어려움을 겪고 	negative
소시지 가격 인상 추진에 소비자단체가 제동을 걸었다	negative
국내 최대 육가공품 생산 업체에 대해 가격 인상 요인이 타당성이 부족하다고	negative
원가 압박 때문이라고 설명했다	negative
돼지고기 가격과 이 업체 제품의 가격 인상율을 분석했다	neutral
소비자에게 돌려주지 않았다고 	negative
구제역 파동 시 돼지고기 가격 급등에 따라 육가공품 제품을 13	negative
락 시에는 제품 가격을 내리지 않았다는 것	neutral
가격 인상을 정당화하고 	neutral
관점에서는 시장 안정을 해칠 수 있다며	negative
183번쨰 기사입니다	neutral
축산 관련 기관 합동 현장점검단’을 상시 운영키로 했다	neutral
일이 될까	neutral
긴장하고 	neutral
방역 등 축산분야 전문성을 갖춘 	neutral
장비 구비와 준수사항의 이행 여부를 합동 점검하고 기술 지도하는 역할을 하게 된다	neutral
미비점을 개선하도록 유도할 방침이다	positive
감시하며 규제 강화 거수 역할을 할 것이라고 긴장하고 	negative
분뇨 및 악취관리 등	neutral
과태료를 부과하면서 농가들을 압박할 것이라고 예상하고 	negative
업무가 주(主)가 될 것으로 우려하고 	negative
규제 강화 거수기 역할을 수행할 것이라고 반발하고 	negative
강화해야 한다고 	neutral
6월 한돈시세가 올 들어 	neutral
각각 올랐다	neutral
올해 돼지 값이 전년 대비 강세를 형성했지만 	neutral
올랐다	neutral
이처럼 올해 돼지 값이 오른 것은 공급량 감소가 주요 원인 중 하나	negative
수입량(17만8천톤→16만3천톤)은 감소하면서 	neutral
여기다 계속된 사회적 거리두기로 가정 내 돼지고기 소비도 호조를 보였다	positive
한돈 후지 등 가공용 수요도 증가하면서 돼지 값 강세를 뒷받침했다	positive
저작권	neutral
협회가 사료업계의 하반기 양돈 인상 사료 움직임에 우려를 표명하며	negative
배합사료 가격을 인상하거나 인상하려는 조짐을 보이고 있다고 지적했다	negative
사료 인상률은 과다하다고 	negative
촉구했다	negative
어려운 농가와의 고통을 함께해야 한다는 것이다	negative
특단의 지원책을 마련할 것	neutral
184번쨰 기사입니다	neutral
예보된 가운데 양돈장 등 축산농가의 전기 화재 예방 노력이 요구되고 	neutral
무더위로 전기 사용량이 폭증하면 전기 합선 및 누전으로 인한 화재와 정전 사고 발생이 증가하기 때문	negative
점검해 화재와 정전 피해에 대비해 줄 것을 당부했다	neutral
전선	neutral
피복 상태와 누전 차단기 작동 여부를 확인하고 전선과 전기기구 주변 먼지나 거미줄을 주기적으로 제거한다	neutral
화재 원인이 될 수 있다	negative
열화상 카메라를 이용하면 전기배선의 위험 요소를 손쉽게 점검할 수 있다	positive
주는 경보기를 설치하고 자가발전기 등을 미리 확보한다	neutral
고온 스트레스로 인한 폐사가 발생할 수 있기 때문에 신속하게 대응하는 것이 중요하다	neutral
이상 점검해야 한다	neutral
만일 발전기 용량이 부족할 경우 환기 시설 등 필수 장비 위주로 가동시켜 열과 유해가스를 신속하게 배출해야 한다	neutral
저작권자 	neutral
중점방역관리지구 내 대부분의 농가들이 8대 방역 시설 설치가 완료된 것으로 나타났다	neutral
341호에서 기한 내 설치가 완료됐다고 	neutral
나머지 5농가도 현재 설치가 진행 중인 것으로 알려졌다	neutral
방역설치를 종용하고 	negative
중점방역관리지구 외 지역은 권고 사항임에도 불구 의무화를 추진하고 	neutral
특히 전라남북도	neutral
돼지 써코 백신 지원 등 각종 정책 사업 지원 배제를 통보하면서 지역 농가들이 반발하고 	negative
명확화토록 일선 지자체에 시달해 줄 것을 요청했다	neutral
이는 일부 시군이 의무사항으로 인지하면서 농가와 지자체간 혼선이 발생	negative
지원책을 마련해 줄 것을 건의했다	neutral
제20대 한돈협회장 선거가 10월에 개최된다	neutral
한돈협회(회장 하태식	neutral
지난 6일 정기이사회를 화상회의로 개최하고	neutral
돈협회장 선거를 위해 선거관리위원회를 구성했다	neutral
이날 이사회는 제20대 선거관리위원으로 정태홍 부회장	neutral
오재곤 부회장	neutral
최상락 충남세종도협의회장	neutral
이준길 이사	neutral
오승주 이사 등	neutral
5명을 선임했다	neutral
선거관리위원회에서 호선으로 선출될 예정이다	neutral
선거관리위원회는 선거인명부 작성	neutral
후보자등록	neutral
?	neutral
투표 및 개표관리	neutral
제반사항을 총괄하게 된다	neutral
위원회의 임기는 위촉일부터 선거종료일까지 이다	neutral
또한 제20대 한돈협회장을 선출하는 제47차 대의원회 임시총회 일자를 확정할 제4차 이사회를 오는	neutral
8월	neutral
31일에 개최키로 결정했다	neutral
경영기획부 이병석 부장을 상무로 승진시켰다	neutral
이병석 상무는 강원대학교 축산학과	neutral
졸업하고	neutral
유통경제학과에서 경영학 박사 학위를 취득했다	neutral
협회에 입사해	neutral
근무해왔으며	neutral
홍보부	neutral
최근까지 협회 경영기획부장을 역임했다	neutral
ASF	neutral
피해농가 보상 업무 총괄 및	neutral
성금 및 수재의연금 모금 진행	neutral
한돈농가의 경영안정을 위한 한돈팜스 개발 구축	positive
?	neutral
한돈혁신센터 법인화 추진	neutral
돼지 도매시장 활성화 업무	neutral
주도적으로 진행해왔다	neutral
185번쨰 기사입니다	neutral
농가에 살처분 선택권을 부여하는 질병관리등급제가 도입된다	neutral
올해 산란계를 시작으로 다른 축종으로 확대될 것으로 보인다	neutral
위험도 평가 방안을 마련해 발표했다	neutral
질병관리등급제는 방역 여건이 양호하고 	neutral
다	neutral
3가지 유형으로 분류하게 된다	neutral
나 유형의 경우 예방적 살처분에서 제외될 수 있도록 했다	neutral
발생할 경우 살처분 보상금을 하향 조정하게 된다	neutral
농축산부는 올해 시범운영 추진 결과를 분석해 다른 축종으로 확대하	neutral
방안을 검토할 예정이다	neutral
정착을 위해서는 농가와 축산 관계자들의 지속적인 관심과 적극적인 방역 노력이 필수적	neutral
저작권자 	neutral
양돈타임스 무단전재 및 재배포 금지임정은다른기사 보기 186번쨰 기사입니다	neutral
올 상반기 국내 써코 감염증이 증가했다	negative
방역 불이행 농가들을 압박하고 있어 논란이 되고 	negative
미발생한 반면 3종 전염병인 PED만 14건으로 집계됐다	neutral
비법정 질병 중 농가에게 흔한 질병으로 생산성을 저해하는 써코바이러스 감염증	negative
복합호흡기병(PRDC)=8→9건 등으로 집계됐다	neutral
현장의 질병 수준을 짐작케 하고 	negative
논란을 자초하고 	negative
특히 최근 경기 남부지역 양돈농가들을 대상으로 차량통제시설 미설치 농가 등 방역 불이행 시	negative
방역 시설을 설치하겠다는 이행계획서 제출을 종용하고 	negative
다른 질병 확산을 불러올 수 있기에 신중해야 한다고 	negative
특히 방역 강화를 이유로 사육을 규제하려는 현 방역 정책은 정부의 전형적인 ‘탁상행정	negative
187번쨰 기사입니다	neutral
검출지점 인근 멧돼지 차단 울타리를 점검하였다	neutral
양성 개체 발견 증가하면서 양돈장 유입 가능성도 커지고 	neutral
오염원 전파를 철저히 차단키로 했다.	neutral
유입 가능성이 커지고 	positive
양성검출지점 주변 농가수는 총 343호로 500m내 6호	neutral
방역 조치를 강화한다는 계획이다	neutral
이에 농축산부는 멧돼지 폐사체 수색 확대와 아울	neutral
농장 내 차량 진입 통제를 전국으로 확대키로 했다	neutral
남부지역은 12월말까지 단계적으로 실시한다는 계획이다	neutral
사람과 접촉이 잦은 모돈사에서 발생위험이 큰 만큼 모돈사 출입 인원 최소화	neutral
농축산부는 경기 남부권 양돈장에 부여된 차량진입통제 조치 기한을 8월말로 연장했다	neutral
기한을 연장키로 했다	negative
출하전 모돈 전수 조사 등 정밀검사와 함께 써코백신 지원 배제 등 불이익을 예고하고 	negative
돼지 출하가 큰 폭으로 감소한 가운데 돼지 값은 두 달 연속 5천원대를 기록했다	negative
하락했으나 지난해 동월 4천889원보다 5	negative
소비 시장은 경직된 상태	negative
이처럼 돼지 값이 강세를 유지한 것은 돼지 출하가 크게 준 때문으로 분석된다	neutral
산지 출하두수는 134만6천마리로 일평균 6만3천여마리를 기록했다	neutral
이에 7월 전체 돼지 출하두수는 일년전(148만5천마리)과 전달	neutral
줄 것으로 추산된다	neutral
전달과 전년 동월 6만4천~6만6천마리와 견줘 적었다	neutral
무더위가 이어져 출하 지체 현상이 당분간 지속될 것으로 전망되고 	negative
출하물량이 크게 줄고 	negative
저작권자 	neutral
양돈타임스 무단전재 및 재배포 금지임정은다른기사 보기 188번쨰 기사입니다	neutral
축산단체들이 사료 값 인하 요인 발생 시 즉각 반영해 줄 것을 사료협회에 요청했다	neutral
조충훈 사료협회장과 면담을 갖고	neutral
깊은 유감을 표명했다	negative
환율 상승 등 사료업계의 어려움은 공감한다면서도 추후에는 가격 인상 요인 발생 시 현장 축산농가의 어려움을 먼저 헤아려 사료회사들의 이윤 폭 축소 차원에서의 사료가격 인상을 자제해 줄 것을 주장했다	neutral
경영 압박이 심각한 상황이다	negative
금일 축산단체의	neutral
의견을 진지하게 받아들인다	positive
강원도 현장상황실을 방문하여 최문순 강원도지사를 비롯한 관계자가 참석한 가운데 아프리카돼지열병 현장 대응상황을 점검하고 일선 현장의 방역 관계자를 격려하였다	positive
정밀 검사 결과 모두 음성으로 나타났다	neutral
역학농장과 강원도 전체 양돈농장에 대해 아프리카돼지열병	neutral
모두 음성으로 나타났다	negative
검사를 실시하고 있고 현재까지 16호가 음성이며	neutral
역학농가 이외의 강원도 전체 양돈농장(113호)에 대해서도 8월 14일까지 검사를 완료할 계획이라고 밝혔다	neutral
이행 여부를 점검하고 	neutral
또한 강원도 고성군 등 15개 시	neutral
주요 도로에 광	neutral
동원하여 집중 소독을 실시하고 	neutral
올 여름처럼 더위가 기승을 부릴 때는 돼지고기 구매가 더 증가한다는 분석이 나왔다	neutral
소비유형 변화’를 발표했다	neutral
늘었다	positive
감소했다	negative
소비하는 외식비용이 더 많았다	positive
구매액 비중이 증가했다	neutral
수요가 늘어나는 즉석식품이나 보양식 등 농식품을 활용한 신제품 개발도 필요하다	neutral
저작권자 	neutral
양돈타임스 무단전재 및 재배포 금지임정은다른기사 보기 189번쨰 기사입니다	neutral
강원 인제군 소재 양돈장서	neutral
ASF가 발생했다	neutral
추가로 확인되었다고 	neutral
발생농장(약 1,736마리 사육) 인근 3km	neutral
내 돼지농장은 없고	negative
정밀검사 결과 ASF로 확인되었다	neutral
집중 소독 등 강화된 방역조치를 실시하고 	neutral
신속하게 신고해 줄 것을 당부하였다	neutral
190번쨰 기사입니다	neutral
최근 돼지 값이 예상을 크게 웃도는 가운데 향후 전망치도 상향 조정됐다	positive
형성할 것으로 내다봤다	neutral
양돈 관측치에 비해서도 높아진 수치다	neutral
재확산과 폭염으로 가정 내 수요가 증가한 영향으로 풀이했다	neutral
여기다	neutral
돈 출하 감소도 지적됐다	negative
농경연은 7~8월 폭염일수 증가와 9월 작업일수 감소로 3분기 돼지 출하가 416만마리로 전년 동기보다 3.6	negative
반면 한돈 시세가 높고 	neutral
여기다 수요도 호조를 보일 것으로 내다봤다	positive
돼지 값을 끌어 올리면서 	positive
시세가 높고 벨기에선 돼지고기 수입 재개 등으로 3분기 수입량은 전년 대비 9.5	neutral
돼지 값으로는 가장 높은 수준이다	neutral
저작권자 	neutral
양돈타임스 무단전재 및 재배포 금지임정은다른기사 보기 191번쨰 기사입니다	neutral
감염 멧돼지가 점점 남쪽으로 발생이 진행되는 것을 볼 수 있다	neutral
?	negative
확산에 대한 위기감이 높아지고 	negative
8월에만 세 농장	neutral
발생 원인은 야생 멧돼지와 직접적인 연관이 있는 것으로 추정되고 	neutral
검출 지역이 남하하는 양상을 보이면서 양돈장 발생도 증가하고 	negative
방역당국에 강력 촉구했다	negative
벨기에산 돼지고기가 이달부터 본격적으로 수입이 재개된다	neutral
하반기 우려했던 돼지고기 수입 확대의 신호탄이 될 가능성을 배제하기 어렵게 됐다	negative
담은 농축수산물 가격 안정 대책을 발표했다	neutral
돼지고기와 쇠고기는 국민 지원금 지급으로 수요가 늘어 가격이 오를 것을 우려해 농협 계통 출하물량을 늘리고 	neutral
돼지고기의 경우 출하 체중 기준을 115~120㎏에서 110~115㎏로 낮춰 조기 출하를 유도키로 했다	neutral
특히 벨기에산 돼지고기 수입을 재개해 평년 대비 수입을 5	neutral
수입된 물량이 시장에 원활히 공급되도록 민간 검사 기관을 활용해 수입검사 기간을 단축	neutral
발생하면서 수입이 중단됐다	negative
이후 벨기에는 ASF 퇴치 노력 끝에 지난해 12월 ASF 청정국 지위를 회복했	positive
.	neutral
벨기에를 돼지고기 수입 허용국가로 재지정한 바 있다	neutral
(9천300톤)에 불과했다	neutral
수입이 재개되면 이를 넘어설 가능성이 다분하다	neutral
국가들로부터 수입이 늘었다는 점을 눈여겨봐야 한다	neutral
이상 늘었다	neutral
이들 국가 대부분 지난해 전체 수입 물량을 이미 넘어섰다	neutral
높은 수요가 뒷받침되면서 독일산 수입 중단 여파는커녕 되레 다른 EU 국가로부터 이를 상쇄하고도 남을 만큼 수입이 증가한 것이다	negative
수출 시장이 절실하다는 점도 우려를 사고 	negative
회원국들의 돼지 값이 바닥을 치고 	negative
달했으며 올해도 5월말 59	neutral
최근 중국의 돼지고기 수입 감소에 따른 타격이 다른 수출국에 비해 클 수밖에 없다	negative
때문에 줄어든 중국 수출 물량을 받아줄 다른 수출시장이 필요한 상황	neutral
우리 정부는 돼지 값 안정을 이유로 수입 확대를 추진하고 	neutral
따라서 	neutral
수입육이 시장 부담을 더 높이지 않을지 우려되고 	negative
저작권자 	neutral
기사 보기 192번쨰 기사입니다	neutral
한돈도 5천원대 강세가 지속될 것으로 전망됐다	positive
평년(4천802원)에 비해서도 상승할 것으로 추산했다	neutral
연속 5천원대 강세를 유지할 것이란 얘기다	neutral
무엇보다 높은 수요가 돈가 강세를 뒷받침할 것이란 분석이다	neutral
감소한 149만6천마리에 그칠 것으로 추산했다	negative
지급을 시작한 국민 지원금이 한돈 수요를 늘리면서 9월도 강세 기조가 이어질 것으로 농견연은 내다봤다	positive
다만 돼지고기 수입량은 한돈 가격 상승으로 전년 대비 8.5	neutral
작년과 비슷하거나 다소 낮을 것으로 예상했다	neutral
농경연은 향후 돼지 사육두수에 대해서는 12월 1천154만2천마리로 전년 수준을	neutral
산했다	neutral
사육두수 감소에도 생산성 향상으로 전년과 비슷하고 	positive
저작권자 	neutral
양돈타임스 무단전재 및 재배포 금지임정은다른기사 보기  축산업 특성상 근로기준법상 근로시간이나 휴게	neutral
휴일 규정의 적용을 예외로 조항이 합헌이라는 결정이 나왔다	neutral
이 같이 선고했다	neutral
임금을 지급받지 못했다	negative
청구인의 기본권을 침해한다고 	negative
동식물의 채포?	neutral
수산 사업에는 적용치 않는다는 내용이다	neutral
경제적 부작용이 초래될 위험이 있다	negative
해당 조항이 평등권을 침해하는지에 대해서는 근로기준법상 근로시간 및 휴일에 관한 조항이 전제하고 	negative
합당하다고 지적했다	neutral
법령의 전면적 또는 부분적 적용 제외를 인정하고 	neutral
저작권자 	neutral
양돈타임스 무단전재 및 재배포 금지임정은다른기사 보기 193번쨰 기사입니다	neutral
정보 교류의 시간을 가졌다	neutral
서울 그랜드 인터컨티넨탈 파르나스에서 온오프라인으로 학술 세미나를 개최했다	neutral
이날 각국 대표자들은 자국 축산업에 대해 발표했다	neutral
절반 감소했다고 	neutral
축산업 발전 가능성이 매우 높은 것으로 분석됐다	positive
축산업 발전 잠재력이 높아 향후 국내 동물용의약품 업체들의 수출 모색도 가능할 것으로 내다봤다	positive
코로나 팬데믹 상황 속에서도 국내 동약업계가 수출 시장 개척에	neutral
강조했다	positive
가축분뇨의 가치가 재평가될 수 있을까	neutral
가축분뇨 에너지화 사업을 확대키로 했다	positive
농림축산식품부는 내년 가축분뇨 공동자원화 사업을 개선해 그동안 퇴액비화에 집중됐던 처리 방식을 신재생 에너지 생산 등으로 다양화할 계획이라고 밝혔다	positive
사업 집행이 부진했다	negative
그 한계가 지적돼 왔다	negative
가축분뇨를 활용한 에너지화 등에 대한 요구도 높아지는 상황이다	neutral
공동자원화 사업을 대폭 개선키로 했다	positive
사업을 지원하고 민간기업에도 사업 참여의 길을 열어	positive
사업기간을 당초 2년에서 3년으로 확대했다	neutral
아울러 환경부의 친환경 에너지타운 조성사업과 에너지 사업을 연계해 주민 수용성을	positive
높이기로 했다	neutral
경관시설 등 설치를 지원하는 사업이다	positive
농가 단위 에너지화 시설 설치도 지원한다	positive
농축산부는 농가형 에너지화 시설을 확대하기 위해 대규모 양돈농가	positive
비농업적 방식으로 처리해 이용하고 있는 전국의 다양한 사례를 조사했다	neutral
홍보도 진행해 나간다는 계획이다	neutral
지역주민들과 상생하는 좋은 사례로 이어질 수 있기를 기대한다	positive
저작권자 	neutral
양돈타임스 무단전재 및 재배포 금지임정은다른기사 보기 194번쨰 기사입니다	neutral
NULL195번쨰 기사입니다	neutral
강원도 정선의 야생 멧돼지에서 ASF가 첫 검출	neutral
검출되면서 긴장이 고조되고 	negative
정선군 임계면과 여량면의 야생멧돼지가 ASF 진단을 받았다	neutral
멧돼지에서 ASF가 검출됐다	negative
춘천시 동산명 원창리에서 폐사한 야생멧돼지에서 ASF가 검출됐다	negative
검출된 지역은 양돈농가 8호 중 6호가 위치한 것으로 알려졌다	neutral
수준을 일찍이 넘어섰다	neutral
농가들의 원성을 사고 	negative
지역에서 발생했다는데 전문가들은 우려를 표명하고 	negative
파악하여 즉시 시정조치 되어야 한다	negative
196번쨰 기사입니다	neutral
연속 5천원을 넘기며 9월 시세가 올 최고치를 기록했다	positive
오르면서 	positive
회복하며 이례적인 강세를 이어갔다	positive
무엇보다 공급량이 적었던 때문	neutral
소폭 감소하면서 	negative
.	neutral
가량 적었다	neutral
적었다	neutral
감소한 것과 비교하면 3분기 감소폭이 가장 컸던 셈이다	neutral
여기다 소비도 한 몫 했다	neutral
정상 등교가 확산되면서 저지방 부위에 대한 가공용 수요와 급식 수요가 증가했다	neutral
연속 연휴가 겹치면서 	positive
저작권자 	neutral
양돈타임스 무단전재 및 재배포 금지임정은다른기사 보기  겨울철 대비 ASF	neutral
구제역 등 가축 전염병 특별 방역 대책이 추진된다.	neutral
구제역	neutral
특별방역대책기간으로 정하고	neutral
방역 강화 골자는 멧돼지 집중 포획 및 8대 방역 시설 단계적 확대	neutral
분뇨 이동 제한이다	neutral
양돈장으로 전파 위험이 높은 상황이라고 진단했다	negative
농장 차단방역 강화와 함께 오염원 전파 차단에 주력키로 했다	neutral
오염원의 양돈농장 유입을 막기 위해 중점방역관리지구에 설치된 8대 농장 방역시설을 단계적으로 전국적으로 확대키로 했다	neutral
발생 초기 설정한 4대 권역	neutral
강원북부	neutral
분뇨 이동을 통제키로 했다	neutral
구제역 방역 강화를 위해 	neutral
양돈장 ASF가 발생했다	neutral
양성 반응이 나왔다	neutral
해당 농장 돼지 700여마리가 살처분 될 예정이다	neutral
발생해 돼지 1천700여마리가 살처분 된 바 있다	negative
재입식 농가들의 출하가 본격화되고 	neutral
출하 대란이 예고되고 	negative
농가를 대상으로 재입식을 허용했다	neutral
재기의 발판을 마련했다	positive
농가들의 출하가 이달부터 본격화되고 	neutral
경기북부지역 출하물량을 관내 도축장들이 소화화지 못할 것이라는 우려가 제기되면서 	negative
이후 월 출하두수는 1만두를 시작으로 점점 늘어 	neutral
만두를 상회할 것으로 나타났다	neutral
철원 도축장에서만 작업하도록 되어	neutral
향후 재입식 농가들의 출하 증가로 해당 지역의 도축장이 과부하가 발생할 것으로 전망	negative
이에 해당 농가들은 도축장 과부하를 사전에 방지하기 위해서는 경기 남부 지역 도축장에도 출하를 확대해야 한다고 	neutral
도축 대란을 사전에 방지하기 위해 재입식 농가 도축장 출하처 확대 등이 필요할 이라고 주장하고 	neutral
197번쨰 기사입니다	neutral
한돈 요리에 정통한 전문가 ‘한돈 소믈리에	neutral
한돈 소믈리에	neutral
손님이 주문한 요리와 어울리는 와인을 손님에게 추천하는 일을 전문으로 하는 사람을 뜻하는 직업으로	neutral
한돈의 우수성을 널리 알리고자 자조금이 야심차게 기획했다	positive
자격을 부여할 계획이다	neutral
또한 	neutral
(바로가기)를 통해 신청서를 작성하면 된다	neutral
사전 수강 신청자를 대상으로 추첨을 통해 스타벅스 기프티콘을 500명에게 지급할 예정이다	positive
자격과정 수강자 대상으로도 푸짐한 경품을 증정한다	positive
상위 고득점자에게는 한정판 굿즈를 증정한다	positive
전문 교육강사진의 퀄리티 높은 강의들로 구성됐다	positive
한돈 조리법 등을 배울 수 있다	neutral
전문 지식을 습득할 수 있다	positive
이해할 수 있도록 한돈의 모든 것을 설명한다	neutral
알리는 한돈 소믈리에에 많은 관심 부탁드린다	neutral
구제역 발병위험에 대비 내년 2월까지 5개월간	negative
범농협 가축질병 특별방역대책기간으로 설정하고 방역활동을 강화키로 했다	neutral
추진키로 했다.	neutral
시행중에 있다.	neutral
상당의 방역용품을 지원 한 바 있다	positive
차단방역에 앞장서겠다	neutral
기록하면서 양돈 선진국 성적과 어깨를 나란히 하고 	positive
협회는 이 같은 혁신센터의 높은 성적 비결을 교육 활동을 통해 농가 및 업계에 전파할 계획이라고 밝혔다	positive
협회는 최근 	neutral
국내 농가들에게 1년간의 성적을 공개했다	neutral
시작으로 출하가 본격 진행됐다	neutral
두가 비육 출하됐으며 이 돼지들의 평균 체중은 117.1	neutral
1등급 이상 출하 비율은 74	neutral
추정)보다 현저히 낮았다	neutral
이에 따라 평균 MSY는 31.2두	neutral
이는 국내 최고 성적과 동시에 해외와 견줘도 손색없는 성적이다	positive
혁신센터는 성적 공개와 아울러 내년도 사업계획도 발표했다	neutral
추진해 교육과 체험 견학 사업 확대키로 했다	positive
냄새 관련 민원인 견학 등을 진행한다는 계획이다	neutral
198번쨰 기사입니다	neutral
방문하여 ASF 방역 추진상황을 점검	neutral
가용 인력을 총동원해 멧돼지 서식밀도를 최소화해 줄 것을 강조	neutral
포획을 강화하고 	neutral
자조금도 야생 멧돼지 사체 수색에 1억5천만원을 지원키로 하고	neutral
색에 적극 돕기로 했다	neutral
포획을 강화하고 	neutral
본부에 따르면 10월11일~13일간 야생 멧돼지 포획 마릿수는 △기존 발생지역	neutral
멧돼지 포획 마릿수가 크게 증가하고 	neutral
증액(27→37만원) 등을 추진하겠다고 	neutral
협회도 야생 멧돼지 포획에 적극 돕기로 했다	positive
예산 1억5천만원을 지원키로 했다	neutral
산속 험로 등 깊은 곳까지 집중 수색 가능하도록 전문 인력 고용에 사용될 계획이다	neutral
199번쨰 기사입니다	neutral
도축업계가 어수선하다	negative
경영 악화를 이유로 도축장들이 잇달아 폐업을 추진하고 	negative
경제적 피해가 우려되고 	negative
돼지 도축작업을 중단키로 결정했다	neutral
확산 추세에 따른 사업성 악화로 월 1억원의 영업	negative
실이 발생	neutral
롯데푸드 김천 도축장은 올 12월말로 폐업할 계획인 것으로 알려졌다	negative
사업 부진에 성장가능성도 낮기 때문이라고 밝히고 	negative
할 계획인 것으로 알려졌다	positive
문제는 이 도축장이 경북 지역 최대 도축 능력을 가진 도축장이라는 점이다	negative
야기될 것으로 우려된다	negative
시 장기적으로 돈가 안정에도 저해 요소가 될 수 있을 것이라는 지적도 제기되고 	negative
해당업체에 요구하고 	negative
특히 지역내 도축장의 중요성을 감안 폐업시 타기업에 임대 또는 매각을 추진해 줄 것도 요청했다	neutral
농가들에게 피해가 우려되고 	negative
특히 정부의 권역화 정책 변화가 절실하게 요구되고 	neutral
200번쨰 기사입니다	neutral
방역 시설이 전국 양돈농가에 의무화된다	neutral
전국으로 확산될 우려가 증가하고 	negative
전국 양돈장의 방역을 강화할 계획이라고 밝혔다	neutral
신속한 방역 시설 강화가 필요할 것이라고 내다봤다	neutral
법령 개정을 신속 추진키로 했다	neutral
설치토록 농가	neutral
지자체를 독려한다는 계획이다	neutral
정부의 일방통행식 방역시설 전국 확대를 결사반대한다	negative
마련할 것을 촉구했다	negative
시세가 역대 10월 돼지 값 중 최고치를 기록했다	negative
올랐다	positive
돈가는 역대 10월 한돈 시세로는 역대 최고가다	positive
연속 역대 동월 최고가를 경신하는 기록도 만들게 됐다	positive
하락세가 지속되면서 4천200원대까지 떨어졌다	negative
28일에는 5천원대로 재진입하며 강	neutral
기조를 되찾았다	positive
5천원대는 9월 29일 이후 한달 만이다.	neutral
원인은 무엇보다 공급량에서 뚜렷하게 나타난다	neutral
줄었다	negative
이후 도축두수도 크게 늘지 못했다	negative
감소했으며 10월도 지난해 동월	negative
연휴로 예년과 같은 비수기 영향도 덜했던 것으로 파악된다	neutral
저작권자 	neutral
양돈타임스 무단전재 및 재배포 금지임정은다른기사 보기 201번쨰 기사입니다	neutral
누적 돼지고기 수입량이 지난해 물량을 처음으로 추월했다	neutral
수입물량을 넘어섰다	neutral
각각 증가했다	neutral
돼지고기 수입량은 26만9천900톤으로 지난해 같은 기간 26만7천800톤보다 0.8	neutral
수입실적을 넘어선 것은 이번이 처음이다	neutral
내리 작년 수입량을 뛰어넘은 것이다	neutral
연속 감소하던 돼지고기 수입량은 올해 3년만에 다시 증가세로 돌아설 것으로 보인다	neutral
부위별로는 삼겹살이 수입량 증가의 주요 원인으로 분석되고	neutral
있다	neutral
삼겹살 수입량은 10월에도 1만4천여톤에 달하면서 전체 수입량의 50	neutral
현 시점에서 지난해 전체 삼겹살 수입물량 12만9천톤에 비해서도 많았다	neutral
줄었다	neutral
이후 전년대비 증가세로 돌아섰다	neutral
지난해 동월 5천200여톤보다 56.2	neutral
감소했다	neutral
감소한 반면 스페인 5만톤	neutral
저작권자 	neutral
외국인 근로자 입국을 정상화하기로 했다	neutral
입국을 정상화하기로 결정했다	neutral
이는 코로나 장기화로 농어촌과 중소기업의 인력난이 심각한 수준이라는 점과 최근 위드 코로나 전환 등을 고려한 결정이다	negative
외국인근로자 입국 가능 국가를 제한하지 않고 원칙적으로 16개 전 송출국 대	neutral
입국을 허용키로 했다	neutral
입국을 허용키로 했다	neutral
이르면 이달 말부터 입국이 가능할 것으로 예상되고 	neutral
경우 입국을 허용하되 입국 후 국내에서 예방접종을 완료해야 한다	neutral
입국인원 상한도 폐지키로 했다	neutral
추가 연장을 적극 검토해줄 것을 요청했다	neutral
될 수 있다는 분석에 근거한 것이다	negative
수급되기 어려운 형편이다	negative
이에 현장에서 당장 외국인력이 공급되기까지 일정기간 공백이 생길 수 밖에 없는 사정을 고려해 외국인근로자 취업활동 기간이 2021년 12월 31일로 종료되는 국내 외국인 인력에 대해 1년 추가 연장조치를 해줄 것을 고용노동부에 요청했다	neutral
지난해 코로나 이후 외국인 근로자 입국 가능 국가와 인원을 제한해왔다	neutral
이에 코로나 이	neutral
수준으로 감소하면서 농어촌과 산업현장의 인력난이 심화됐다	negative
저작권자 	neutral
절반의 농가는 재입식을 포기한 것으로 나타났다	negative
이에 예방적 살처분 후폭풍이 경기도 지역의 한돈업을 크게 위축시키고 	negative
ASF 중앙사고수습본부(이하 중수본)는 지난해 11월 ASF로 살처분	neutral
농가를 대상으로 재입식을 허용했다	neutral
농가 중 완료된 농가는 108농가로 나타났다	neutral
농가로 크게 줄어	negative
중점방역관리지구 내 사육 기준 강화가 재입식을 지연시키고 	negative
경기 북부 피해 지역은 사육 기반 반토막이라는 후폭풍을 겪고 	negative
지자체를 대상으로 소송도 진행하고 	negative
농가들의 재산권을 보호해야 한다고 	neutral
202번쨰 기사입니다	neutral
손세희 한돈협회장이 임기	neutral
함께할 회장단 및 이사회를 구성했다	neutral
출발을 알린다	neutral
손세희 회장은 임기 4년을 함께할 회장단 및 이사진을 구성했다	neutral
고봉석 등 5명이 선임됐다	neutral
이사에는 △최영길(경기도협의회장) △배상건(강원도협의회장) △이민영(충북도협의회장) △김은호(충남세종도협의회장) △이웅렬(전북도협의회장) △오재곤(전남도협의회장) △최재철(경남도협의회장) △유기옥(경남도협의회장) △김재우(제주도협의회장) △서정용 △오명준 △이재춘 △방희진 △이희영 △조상덕 △김현섭 △임성주 △이기홍 	neutral
당선증 전달식을 가졌다	neutral
경기 연천)씨가 각각 당선됐다	neutral
한돈 농가들과의 지속적인 커뮤니케이션을 이어	neutral
귀를 기울이겠다	positive
소비 촉진에 최선을 다하겠다	positive
위원 보궐선거 당선자의 임기는 2021년 11월 10일부터 2023년 11월 11일까지이다	neutral
출하 돼지의 도체중과 등지방 추이를 쉽게 파악할 수 있는 분석 서비스가 양돈농가에 제공된다	neutral
이달부터 기존 돼지 등급판정 결과와 함께 출하 수준을 한눈에 파악할 수 있는 축산농가 분석서비스를 제공하기 시작했다	positive
돼지 도체중과 등지방의 출하평균 정보를 볼 수 있는 그래프를 개발해 이를 농가 분석서비스에 탑재한 것이다	neutral
제조업 분야에서 사용되는 통계적 품질관리기법(Control Chart)을 도입했다	neutral
조치할 수 있는 장점이 있다	positive
품질향상에 도움이 될 것으로 기대되고 	positive
특히 관리선이 등급 기준으로 설정되어 있어 도체들이 어떤 등급에 가깝게 출하되었는지	neutral
균 정보를 쉽게 확인할 수 있다	neutral
전국 모든 농가가 직접 활용할 수 있다	neutral
의사결정에 큰 도움이 될 것	positive
저작권자 	neutral
양돈타임스 무단전재 및 재배포 금지임정은다른기사 보기 203번쨰 기사입니다	neutral
ASF 중점방역관리지구	neutral
중점방역관리지구에 추가 지정된다	neutral
추가 지역 지정 계획안을 공고했다	neutral
발생 위험을 선제적으로 대비할 필요가 있다고 	neutral
감안한 위험도 평가 결과에 따라 17개 시군을 중점방역관리지구에 추가할 계획이라고 밝혔다	neutral
17개 시군은 △ASF 멧돼지	neutral
봉화 등 264호 농가가 그 대상이다	neutral
설치해야 한다	neutral
한편 추가로 지정될 중	neutral
방역 시설을 설치해야 하는 것으로 나타났다	neutral
양돈장 관리사가 외국인 근로자 숙소로 인정받게 되었다	neutral
관리사를 외국인 근로자 숙소로 인정하는 내용을 골자로 하는 외국인노동자 주거환경 개선 지침 개정안을 지방 노동관서에 시달한 것으로 알려졌다	neutral
안)을 담았다	neutral
이번 지침에서는 예외 규정을 두었다	neutral
관리사로 건축허가를 받은 경우 지방관서에서 고용허가 발급 전 주거시설 현장을 확인하여 근로기준법상 숙소 시설 기준 위반이 없는 경우에는 허용토록 한 것이다	neutral
지속적으로 호소해 왔다	negative
건축법 인용규정을 지침에서 삭제한 것이다	neutral
협회 등 축산단체들의 끈질긴 노력이 결실을 맺었다는 평가다	positive
단양군 야생멧돼지 양성 폐사체 사진	neutral
발생 건수가 지난해를 넘어섰다	negative
발생 범위도 기존 지역을 중심으로 충북지역까지	neutral
확산되고 	neutral
방역당국에 따르면 올 1월~11월 12일 기준 야생 멧	neutral
대비 증가세로 돌아섰다	neutral
최고점으로 3월부터 감소세로 돌아섰다	negative
누적 집계 시 지난해 동월과 비교해 총 발생 건수를 추월했다	neutral
발생은 총 1천700건을 넘어섰다	neutral
이런 가운데 강원 이남에서 처음으로 야생멧돼지서 ASF가 검출됐다	negative
단성면 대잠리 월악산국립공원에서 멧돼지 폐사체가 발견돼 국립야생동물질병관리원에 검사를 의뢰한 결과?	neutral
양성 판정이 나왔다	neutral
충북 제천서도 야생멧돼지서 ASF 의심축이 신고됐다	negative
경기와 강원 이외 지역에서는 발생한 바 없다	neutral
지역으로의 확산이 우려됐다	negative
야생 멧돼지가 발견된 강원도 영월과 인접한 곳이다	neutral
단양군 등 관계기관과 함께 긴급조치를 한다	negative
집중 수색을 진행한다	neutral
기피제 등 임시시설을 긴급히 설치하고 	neutral
특히 총기포획으로 인한 확산을 방지하	neutral
추가 설치하여 멧돼지를 포획할 계획이다	neutral
저작권자 	neutral
양돈타임스 무단전재 및 재배포 금지임정은다른기사 보기 204번쨰 기사입니다	neutral
현장 방문 행보를 이어	neutral
농가의 어려움을 호소하며	negative
대책들이 마련될 수 있도록 해달라	neutral
통하여 적극 대응을 약속했다	neutral
제주도의 경우 숨골 가축분뇨 유출 사건이후 가축분뇨법상의 처벌규정을 조례상으로 강도 높게 재정하여 강한 환경규제를 적용중이다	neutral
문제는 지역과 상관없이 모든 농가가 갖고 있는 어려움이다	negative
확산을 계기로 정부의 전국 8대 방역 시설 요구가 거세지고 	negative
그러나 전문가들은 멧돼지 남하는 정부의 방역 실패라고 지적	negative
한다고 	neutral
전국 확산 우려가 현실이 되어가고 	negative
지자체를 통해 독려하고 	neutral
신속히 제출할 것을 시달했다	negative
방역시설 설치 강요보다는 전국 양돈밀집지역 주변 좁은 지역의 울타리 설치가 효율적이라고 주장하고 	neutral
경북 영주지역에도 이미 오염되었을 것으로 보인다	negative
협회가 정부의 전국 축산농가 특별 점검 중단을 촉구했다	negative
일제 축산관련 규정 준수 여부를 특별점검한다고 	neutral
전국 축산농가 축산관련 규정 준수 특별점검이 명백한 과잉	negative
중단할 것을 촉구했다	negative
명백한 과잉 행정규제라고 반발했다	negative
단속은 방역의 기본을 무시하는 행정규제라고 규정하고	negative
205번쨰 기사입니다	neutral
11월 돼지고기 수입량이 40	neutral
지난해 동월 1만8천700여톤과 견줘서는 무려 40.6	neutral
연속 전년 대비 증가한 동시에 지난해 수입량과의 차이를 더 벌리고 	neutral
이로써 11월말 돼지고기 수입량은 29만6천톤을 기록	neutral
수입이 더 증가하는 예년 수입량 추이를 고려하면 지난해 수입량과의 차이는 더 커질 것으로 예상된다	neutral
지난해 전체 수입량(1만8천800톤)도 훌쩍 뛰어넘었다	neutral
삼겹도 마찬가지다	neutral
많았으며 11월말 누적 수입량은	neutral
↑)는 물론 지난해 전체 삼겹 수입량	neutral
적었다	neutral
작년 동월 대비 수입물량이 늘고 	neutral
증가하며 지난해와의 차이를 더욱 좁혔다	neutral
감소했으며 11월말 4만1천톤을 기록	negative
미국은 줄고	neutral
유럽 국가의 돈육도 지난해보다 크게 늘었다	neutral
저작권자 	neutral
심리적 마지노선 가격은 kg당 2만5천원인 것으로 조사됐다	neutral
소비가 둔화되는 양상이 나타나고 	neutral
소비자들이 생각하는 한돈 삼겹살 가격은 kg당 1만5천~2만원이 적합하다는 응답이 가장 많았다	neutral
특히 심리적 수용가격은 최대 2만5천원이 마지노선이라고 응답했다	neutral
심리적 최대 수용 가격 역시 2만원이 적당하다고 응답했다	neutral
그러나 올해 월별 삼겹 가격 분포도를	neutral
이상을 상회한 이후 삼겹 소비가 크게 줄었다	neutral
덤핑 물량도 꾸준히 출현하고 	neutral
업계가 우려하고 	negative
최근 10년간 월별 삼겹살 kg당 소비자가격 현황	neutral
(출처 	neutral
돼지 출하두수가 170만마리를 넘기며 올 최고치를 기록했다	positive
출하물량 최고 기록을 경신할 가능성이 커졌다	positive
전달 154만마리에 비해 11.5% 많았다	neutral
출하물량이 170만마리를 넘긴 것은 지난 19년 10월 이후 2년여만이다	neutral
늘었다	neutral
생산성도 향상된 영향으로 풀이되고 	positive
이로써 그동안 작년보다 적었던 올 누적 출하물량은 11월말 1천665만마리를 기록하며 지난해 같은 기간 1천662만마리를 근소한 차이로 앞지르게 됐으며 올 연말까지 1천800만마리를 넘길 것으로 보인다	neutral
같은 출하 증가세가 이어질 경우 올해 돼지 출하물량은 사상 최고치였던 지난해 기록을 경신할 가능성도 있다	positive
증가한 16	positive
기록할 것으로 추산했다	neutral
내년에도 모돈 증가세가 이어질 것으로 전망했다	neutral
저작권자 	neutral
보복 행정’이라고 날서게 비판했다	negative
일제 축산관련 규정 준수 여부를 특별 점검하고 	neutral
강한 어조로 비판했다	negative
취임 이후 정부가 내년에 추진하고자 하는 모돈 이력제에 대해 강하게 반대했다	negative
반문했다	negative
경과 후 다음 농장 방문을 강력 요구했다	negative
농가를 대변하는 자리로 규제로 점철돼 있는 정부 정책에 대해 농가를 대신해 목소리를 높여	neutral
익을 사수하는데 	neutral
206번쨰 기사입니다	neutral
국제 경쟁력을 갖춘 농가들로 분석됐다	neutral
농가 전산성적 보고회를 개최했다	neutral
지난해 전국 한돈농가들의 평균 생산 성적은 	neutral
또한 지난해 돈육 수출국들의 PSY와 MSY는 	neutral
두로 나타났다	neutral
비교이 같이 국내와 해외 선진국 양돈농가를 비교하면 생산성의 차이는 크게 차이난다	neutral
육성률도 해외와 비교하면 크게 뒤처지기 때문이다	negative
최소 MSY가 22두는 돼야 한다는 분석이다	neutral
농가는 10곳 중 2곳에 불과한 것으로 나타나고 	neutral
성적별 농가 비율을 분석한 결과 	neutral
△16두 미만	neutral
국내 약 절반의 농가들이 MSY 18두 미만으로 나타났다	neutral
불과했다	negative
2020년	neutral
미만 농가들의 수익 악화로 경영 어려움이 가속화될 것으로 우려되고 	negative
특히 성적이 낮은 농가는 대부분 소규모 농장들로 돈가 하락 시 연쇄 도산이 우려되고 있어 생산성 제고가 시급한 것으로 분석되고 	negative
내년도에는 두당 손익이 더욱 감소할 것으로 보여	negative
207번쨰 기사입니다	neutral
가입 추진을 공식화하면서 농축산업계가 가입 철회를 주장하고 	negative
전략적 가치 등을 고려해 CPTPP 가입을 본격 추진한다	neutral
농축산업계 피해가 어느 무역협정보다 높을 것으로 우려되고 	negative
수준으로 시장 개방도가 높고 	neutral
구획화가 적용된다는 점이 가장 우려되는 지점이다	negative
이미 정부는 4개 분야에 있	neutral
가입을 준비해왔으며 그 중 하나가 위생검역분야다	neutral
구획화 정의를 마련하고 교역 제한을 최소화하는 방향으로 수입위생조건을 정비했다	neutral
구분되는 동물 소집단으로 규정된다	neutral
개별 농장까지 좁혀질 수 있다	neutral
이라고 지적했다	negative
먹거리 주권 포기나 다름없다 할 것이다	negative
이라고 경고했다	negative
기존 회원국 만장일치 승인을 받아야 한다	neutral
가량 걸릴 것으로 전문가들은 예측하고 	neutral
저작권자 	neutral
양돈타임스 무단전재 및 재배포 금지임정은다른기사 보기	neutral
